0304 0305 0306 0464 0465 0304 0305 0306 0779 0779 0779 0779 0779 0779 0779 0779 0779 0779 0779 0779 0779 0779 0779 0779 0779 0779 0779 0779 0779 0779 0779 0779 0779 0779 0779 0779 0779 0779 0779 0779 0779 0779 0779 0779 0779 0779 0779 0779 0779 0779 
0304 0305 0306 0496 0497 0304 0305 0306 0779 0779 0779 0779 0779 0779 0779 0779 0779 0779 0779 0779 0779 0779 0779 0779 0779 0779 0779 0779 0779 0779 0779 0779 0779 0779 0779 0779 0779 0779 0779 0779 0779 0779 0779 0779 0779 0779 0779 0779 0779 0779 
0000 0000 0000 0000 0000 0000 0000 0000 0000 0200 0201 0000 0000 0000 0000 0000 0000 0000 0000 0000 0000 0000 0000 0000 0000 0000 0000 0000 0000 0000 0000 0000 0000 0000 0000 0000 0000 0000 0200 0201 0000 0000 0000 0000 0000 0000 0000 0000 0000 0000 
0683 0683 0683 0683 0683 0683 0683 0683 0683 0232 0233 0683 0683 0683 0683 0683 0683 0683 0683 0683 0683 0683 0683 0683 0683 0683 0683 0683 0683 0683 0683 0683 0683 0683 0683 0683 0683 0683 0232 0233 0683 0683 0683 0683 0683 0683 0683 0683 0683 0683 
0779 0779 0779 0779 0779 0779 0779 0779 0779 0264 0265 0779 0779 0779 0779 0779 0779 0779 0779 0779 0779 0779 0779 0408 0409 0410 0779 0779 0779 0779 0779 0779 0779 0779 0779 0779 0779 0779 0264 0265 0779 0779 0779 0779 0779 0779 0779 0779 0779 0779 
0779 0779 0779 0779 0779 0779 0779 0779 0779 0296 0297 0779 0779 0779 0779 0779 0779 0779 0779 0779 0779 0779 0779 0440 0441 0442 0779 0779 0779 0779 0779 0779 0779 0779 0779 0779 0779 0779 0296 0297 0779 0779 0779 0779 0779 0779 0779 0779 0779 0779 
0000 0000 0000 0000 0000 0000 0000 0000 0000 0328 0329 0000 0000 0000 0000 0000 0000 0000 0000 0000 0000 0000 0000 0000 0000 0000 0000 0000 0000 0000 0000 0000 0000 0000 0000 0000 0000 0000 0328 0329 0000 0000 0000 0000 0000 0000 0000 0000 0000 0000 
0000 0000 0000 0000 0000 0000 0000 0000 0000 0000 0000 0000 0000 0000 0000 0000 0000 0000 0000 0000 0000 0000 0000 0000 0000 0000 0000 0000 0000 0000 0000 0000 0000 0000 0000 0000 0000 0000 0000 0000 0000 0000 0000 0000 0000 0000 0000 0000 0000 0000 
0000 0000 0000 1121 1122 1123 1124 0000 0000 0000 0000 0000 0000 0000 0000 0000 0000 0000 0000 0000 0000 0000 0000 0000 0000 0000 0000 0000 0000 0000 0000 0000 0000 0000 0000 0000 0000 0000 0000 0000 0000 0000 0000 0000 0000 0000 0000 0000 0000 0000 
0000 0000 1152 1153 1154 1155 1156 1157 0000 0000 0000 0000 0000 0000 0000 0000 0000 0006 0006 0000 0000 0000 0000 0000 0000 0000 0000 0000 0000 0000 0000 0000 0000 0000 0000 0000 0000 0000 0000 0000 0000 0000 0000 0000 0000 0000 0000 0000 0000 0000 
0000 0000 1184 1185 1186 1187 1188 1189 0000 0000 0000 0000 0000 0000 0000 0000 0000 0006 0006 0000 0000 0000 0000 0000 0000 0000 0000 0000 0000 0000 0000 0097 0097 0000 0000 0000 0000 0000 0000 0000 0000 0000 0000 0000 0000 0000 0000 0000 0000 0000 
0000 0000 1216 1217 1218 1219 1220 1211 0000 0000 0000 0000 0000 0000 0000 0000 0000 0038 0038 0000 0000 0000 0000 0000 0000 0000 0006 0006 0000 0000 0000 0097 0097 0000 0000 0000 0000 0000 0000 0000 1121 1122 1123 1124 0000 0000 0000 0000 0000 0000 
0000 0000 0096 1249 1250 1251 1252 0096 0000 0000 0000 0000 0000 0000 0000 0000 0000 0000 0000 0000 0000 0000 0000 0000 0000 0000 0006 0006 0000 0000 0000 0000 0000 0000 0000 0000 0000 0000 0000 1152 1153 1154 1155 1156 1157 0000 0000 0000 0000 0000 
0000 0000 0000 0000 0000 0000 0000 0000 0000 0000 0000 0000 0000 0000 0000 0000 0000 0000 0000 0000 0000 0000 0000 0000 0000 0000 0038 0038 0000 0000 0000 0000 0000 0000 0000 0000 0000 0000 0000 1184 1185 1186 1187 1188 1189 0000 0000 0000 0000 0000 
0000 0000 0000 0000 0000 0000 0000 0000 0000 0000 0000 0000 0000 0000 0000 0000 0000 0000 0000 0000 0000 0000 0000 0000 0000 0000 0000 0000 0000 0000 0000 0070 0000 0000 0000 0000 0000 0000 0000 1216 1217 1218 1219 1220 1211 0000 0000 0000 0000 0000 
0000 0000 0000 0000 0000 0000 0000 0000 0000 0000 0000 0000 0000 0000 0000 0000 0000 0000 0000 0000 0000 0000 0000 0000 0000 0000 0000 0000 0000 0000 0000 0000 0000 0000 0000 0000 0000 0000 0000 0096 1249 1250 1251 1252 0096 0000 0000 0000 0000 0000 
0000 0000 0000 0000 0000 0000 0000 0000 0000 0000 0000 0000 0000 0000 0000 0000 0000 0000 0000 0000 0000 0000 0000 0000 0000 0000 0000 0000 0000 0000 0000 0000 0000 0000 0000 0000 0000 0000 0000 0000 0000 0000 0000 0000 0000 0000 0000 0000 0000 0000 
0000 0000 0000 0000 0000 0000 0000 0000 0000 0000 0000 0000 0000 0000 0000 0000 0000 0000 0000 0000 0000 0000 0000 0000 0000 0000 0000 0000 0000 0000 0000 0000 0000 0000 0000 0000 0000 0000 0000 0000 0000 0000 0000 0000 0000 0000 0000 0000 0000 0000 
0000 0000 0000 0000 0000 0000 0000 0000 0000 0000 0000 0000 0000 0000 0000 0000 0000 0000 0000 0000 0000 0000 0000 0000 0000 0000 0000 0000 0000 0000 0000 0000 0000 0000 0000 0000 0006 0006 0000 0000 0000 0000 0000 0000 0000 0000 0000 0000 0000 0000 
0000 0000 0000 0070 0000 0000 0000 0000 0000 0000 0000 0000 0000 0000 0000 0000 0000 0000 0000 0000 0000 0000 0000 0000 0000 0000 0000 0000 0000 0000 0000 0000 0000 0000 0000 0000 0006 0006 0000 0000 0000 0000 0000 0000 0000 0000 0000 0000 0000 0000 
0000 0000 0000 0000 0000 0000 0000 0000 0000 0006 0006 0000 0000 0000 0000 0000 0000 0000 0000 0000 0000 0000 0000 0000 0000 0000 0000 0000 0000 0000 0000 0000 0000 0000 0000 0000 0038 0038 0000 0000 0000 0000 0000 0000 0000 0000 0000 0000 0000 0000 
0000 0000 0000 0000 0000 0000 0000 0000 0000 0006 0006 0000 0000 0000 0000 0000 0000 0000 0000 0000 0000 0000 0000 0000 0000 0070 0000 0000 0000 0000 0000 0000 0000 0000 0000 0000 0000 0000 0000 0000 0000 0000 0000 0000 0000 0000 0000 0000 0000 0000 
0000 0000 0000 0000 0000 0000 0000 0000 0000 0038 0038 0000 0000 0000 0000 0000 0000 0097 0097 0000 0000 0000 0000 0000 0000 0000 0000 0000 0000 0000 0000 0000 0097 0097 0000 0000 0000 0000 0000 0000 0000 0000 0000 0000 0000 0000 0000 0000 0000 0000 
0000 0000 0000 0000 0000 0000 0000 0000 0000 0000 0000 0000 0000 0000 0000 0000 0000 0097 0097 0000 0000 0000 0000 0000 0000 0000 0000 0000 0000 0000 0000 0000 0097 0097 0000 0000 0000 0000 0000 0000 0000 0000 0000 0000 0000 0000 0000 0000 0000 0000 
0000 0000 0000 0000 0000 0097 0097 0000 0000 0000 0000 0000 0000 0000 0000 0000 0000 0000 0000 0000 0000 0000 0000 0000 0000 0000 1121 1122 1123 1124 0000 0000 0000 0000 0000 0000 0000 0000 0000 0000 0000 0000 0000 0000 0000 0000 0000 0000 0000 0000 
0000 0000 0000 0000 0000 0097 0097 0000 0000 0000 0000 0000 0000 0000 0000 0000 0000 0000 0000 0000 0000 0000 0000 0000 0000 1152 1153 1154 1155 1156 1157 0000 0000 0000 0000 0000 0000 0000 0000 0000 0000 0000 0000 0000 0000 0000 0000 0000 0000 0000 
0000 0000 0000 0000 0000 0000 0000 0000 0000 0000 0000 0000 0000 0000 0000 0000 0000 0000 0000 0000 0000 0000 0000 0000 0000 1184 1185 1186 1187 1188 1189 0000 0000 0000 0000 0000 0000 0000 0000 0000 0000 0000 0000 0000 0000 0000 0000 0000 0000 0000 
0000 0000 0000 0000 0000 0000 0000 0000 0000 0000 0000 0000 0000 0000 0000 0000 0000 0000 0000 0000 0000 0000 0000 0000 0000 1216 1217 1218 1219 1220 1211 0000 0000 0000 0000 0000 0000 0000 0000 0000 0000 0000 0000 0000 0000 0000 0000 0000 0000 0000 
