025 033 033 033 033 033 033 033 033 033 033 033 033 033 033 033 033 033 033 033 033 033 033 033 033 033 033 033 033 033 033 033 033 033 033 033 033 033 033 033 033 033 033 033 033 033 033 033 033 025 
026 041 041 041 041 041 041 041 041 041 041 041 041 041 041 041 041 041 041 041 041 041 066 041 041 041 067 041 041 041 041 041 041 041 041 041 041 041 041 041 041 041 041 041 041 041 041 041 041 024 
026 049 049 049 049 049 049 049 049 049 049 049 049 049 049 049 049 049 049 049 049 049 074 049 049 049 075 049 049 049 049 049 049 049 049 049 049 049 049 049 049 049 049 049 049 049 049 049 049 024 
026 057 057 057 057 057 057 057 057 057 057 057 057 057 057 057 057 057 057 057 057 057 082 057 057 057 083 057 057 057 057 057 057 057 057 057 057 057 057 057 057 057 057 057 057 057 057 057 057 024 
026 000 000 000 000 000 000 000 000 000 000 000 000 000 000 000 000 000 000 000 000 000 000 131 132 133 000 000 000 000 000 000 000 000 000 000 000 000 000 000 000 000 000 000 000 000 000 000 000 024 
026 000 000 000 000 000 000 000 000 000 000 000 000 000 000 000 000 000 000 000 000 000 000 139 140 141 000 000 000 000 000 000 000 000 000 000 000 000 000 000 000 000 000 000 000 000 000 000 000 024 
026 000 000 000 000 000 000 000 000 000 000 000 000 000 000 000 000 000 000 000 000 151 000 147 148 149 000 151 000 000 000 000 000 000 000 000 000 000 000 000 000 000 000 000 000 000 000 000 000 024 
026 000 000 000 000 000 000 000 000 000 000 000 000 000 000 000 000 000 000 000 000 159 000 155 156 157 000 159 000 000 000 000 000 000 000 000 000 000 000 000 000 000 000 000 000 000 000 000 000 024 
026 000 000 000 000 000 000 000 000 000 000 000 000 000 000 000 000 000 000 000 000 000 000 000 000 000 000 000 000 000 000 000 000 000 000 000 000 000 000 000 000 000 000 000 000 000 000 000 000 024 
026 000 000 000 000 000 000 000 000 000 000 000 000 000 000 000 000 000 000 000 000 000 000 000 000 000 000 000 000 000 000 000 000 000 000 000 000 000 000 000 000 000 000 000 000 000 000 000 000 024 
026 000 000 000 000 144 145 146 000 000 000 144 145 146 000 000 000 144 145 146 000 000 000 000 000 000 000 000 000 144 145 146 000 000 000 144 145 146 000 000 000 144 145 146 000 000 000 000 000 024 
026 000 000 000 000 152 153 154 000 000 000 152 153 154 000 000 000 152 153 154 000 000 000 000 000 000 000 000 000 152 153 154 000 000 000 152 153 154 000 000 000 152 153 154 000 000 000 000 000 024 
026 000 000 000 000 000 000 000 000 000 000 000 000 000 000 000 000 000 000 000 000 000 000 000 000 000 000 000 000 000 000 000 000 000 000 000 000 000 000 000 000 000 000 000 000 000 000 000 000 024 
026 000 000 000 000 000 000 000 000 000 000 000 000 000 000 000 000 000 000 000 000 000 000 000 000 000 000 000 000 000 000 000 000 000 000 000 000 000 000 000 000 000 000 000 000 000 000 000 000 024 
026 000 000 000 000 144 145 146 000 000 000 144 145 146 000 000 000 144 145 146 000 000 000 000 000 000 000 000 000 144 145 146 000 000 000 144 145 146 000 000 000 145 146 146 000 000 000 000 000 024 
026 000 000 000 000 152 153 154 000 000 000 152 153 154 000 000 000 152 153 154 000 000 000 000 000 000 000 000 000 152 153 154 000 000 000 152 153 154 000 000 000 152 153 154 000 000 000 000 000 024 
026 000 000 000 000 000 000 000 000 000 000 000 000 000 000 000 000 000 000 000 000 000 000 000 000 000 000 000 000 000 000 000 000 000 000 000 000 000 000 000 000 000 000 000 000 000 000 000 000 024 
026 000 000 000 000 000 000 000 000 000 000 000 000 000 000 000 000 000 000 000 000 000 000 000 000 000 000 000 000 000 000 000 000 000 000 000 000 000 000 000 000 000 000 000 000 000 000 000 000 024 
026 000 000 000 000 144 145 146 000 000 000 144 145 146 000 000 000 144 145 146 000 000 000 000 000 000 000 000 000 144 145 146 000 000 000 144 145 146 000 000 000 144 145 146 000 000 000 000 000 024 
026 000 000 000 000 152 153 154 000 000 000 152 153 154 000 000 000 152 153 154 000 000 000 000 000 000 000 000 000 152 153 154 000 000 000 152 153 154 000 000 000 152 153 154 000 000 000 000 000 024 
026 000 000 000 000 000 000 000 000 000 000 000 000 000 000 000 000 000 000 000 000 000 000 000 000 000 000 000 000 000 000 000 000 000 000 000 000 000 000 000 000 000 000 000 000 000 000 000 000 024 
026 000 000 000 000 000 000 000 000 000 000 000 000 000 000 000 000 000 000 000 000 000 000 000 000 000 000 000 000 000 000 000 000 000 000 000 000 000 000 000 000 000 000 000 000 000 000 000 000 024 
025 017 017 017 017 017 017 017 017 017 017 017 017 017 017 017 017 017 017 017 017 018 000 000 000 000 000 016 017 017 017 017 017 017 017 017 017 017 017 017 017 017 017 017 017 017 017 017 017 025 
025 025 025 025 025 025 025 025 025 025 025 025 025 025 025 025 025 025 025 025 025 026 000 000 000 000 000 024 025 025 025 025 025 025 025 025 025 025 025 025 025 025 025 025 025 025 025 025 025 025 
033 033 033 033 033 033 033 033 033 033 033 033 033 033 033 033 033 033 033 033 033 034 000 000 000 000 000 032 033 033 033 033 033 033 033 033 033 033 033 033 033 033 033 033 033 033 033 033 033 033 
041 041 041 041 041 041 041 041 041 041 041 041 041 041 041 041 041 041 041 041 041 042 000 000 000 000 000 040 041 041 041 041 041 041 041 041 041 041 041 041 041 041 041 041 041 041 041 041 041 042 
048 049 049 049 049 049 049 049 049 049 049 049 049 049 049 049 049 049 049 049 049 050 000 000 000 000 000 048 049 049 049 049 049 049 049 049 049 049 049 049 049 049 049 049 049 049 049 049 049 050 
056 057 057 057 057 057 057 057 057 057 057 057 057 057 057 057 057 057 057 057 057 058 000 000 000 000 000 056 057 057 057 057 057 057 057 057 057 057 057 057 057 057 057 057 057 057 057 057 057 058 