000 000 000 000 000 000 000 000 000 000 000 000 000 001 000 000 000 000 000 000 000 000 000 000 000 000 000 000 000 000 000 000 000 000 000 000 000 000 000 054 054 054 000 000 000 000 000 000 000 000 
000 000 000 000 000 000 000 000 000 000 000 000 000 000 000 000 000 000 000 000 000 000 000 000 000 000 000 000 000 000 014 000 000 000 007 000 000 000 055 057 070 057 045 000 000 000 000 000 000 000 
000 007 000 000 000 000 000 000 000 000 000 000 000 000 000 000 000 000 000 000 000 000 000 000 000 000 000 000 000 000 000 000 000 000 000 000 000 055 058 073 078 073 045 000 014 000 000 000 000 000 
000 000 000 000 000 000 000 000 000 000 000 000 000 000 000 000 000 000 000 000 000 000 000 000 000 000 000 000 000 000 000 000 000 000 000 000 047 058 074 000 000 000 045 000 000 000 000 000 000 000 
000 000 000 000 000 000 000 000 000 000 000 000 007 000 000 000 000 000 000 000 000 000 000 054 054 054 054 054 054 054 054 054 054 054 054 054 055 074 000 000 000 000 045 000 000 000 000 000 000 000 
000 000 000 000 000 000 000 000 000 000 000 000 000 000 000 000 000 000 000 000 000 054 055 057 057 057 057 057 057 057 057 057 057 057 057 057 058 000 000 000 000 000 045 000 000 000 000 000 000 000 
000 000 000 000 000 000 000 000 000 000 000 000 000 000 000 000 000 000 000 054 055 057 058 073 073 073 073 073 073 073 073 073 073 073 073 073 074 000 000 000 000 037 000 000 000 000 000 000 000 000 
001 000 000 000 000 000 000 000 000 000 000 000 000 000 000 000 054 054 055 057 058 073 074 000 000 000 000 000 000 000 000 000 000 000 000 000 000 000 000 000 037 000 000 000 000 000 000 000 000 000 
000 000 000 000 000 000 000 000 000 000 000 000 000 000 054 055 057 057 058 073 074 000 000 000 000 000 037 038 038 038 038 038 038 038 038 038 038 038 038 038 000 000 000 000 000 000 000 000 000 000 
000 000 000 000 000 000 000 000 000 000 000 000 054 055 073 073 073 073 074 000 000 000 000 037 038 037 000 000 000 000 000 000 000 000 000 000 000 000 000 000 000 000 000 000 000 000 000 000 000 000 
000 000 000 001 000 000 000 000 000 000 000 055 073 074 000 000 000 000 000 000 000 001 000 045 000 000 000 000 000 000 000 000 000 001 000 000 000 000 000 000 054 054 054 000 000 000 000 000 000 000  
000 000 000 000 000 000 000 000 000 000 047 058 000 000 000 000 000 000 037 039 000 000 000 053 054 000 000 000 000 000 007 000 000 000 000 000 000 000 000 055 073 073 073 045 000 000 000 000 000 000 
000 000 000 000 000 000 000 000 000 000 047 074 000 037 038 038 038 038 000 000 039 000 000 072 057 053 054 000 000 000 000 000 000 000 000 000 000 000 055 074 000 000 000 045 000 000 000 000 000 000 
000 000 000 000 000 000 000 000 000 000 047 000 000 045 000 000 000 000 000 000 000 039 000 000 000 056 057 045 000 000 000 000 000 000 000 054 054 055 074 000 000 000 037 000 000 000 000 000 000 000 
000 000 000 000 000 000 000 014 000 000 047 000 000 045 000 000 000 000 000 000 000 000 039 000 000 072 073 045 000 000 000 000 054 054 055 073 073 074 000 000 000 045 000 000 000 000 000 000 000 000 
000 000 000 000 000 000 000 000 000 000 047 000 000 053 054 000 014 000 000 000 000 000 000 039 000 000 000 045 000 000 000 055 073 073 074 000 000 000 000 000 000 045 000 000 001 000 000 000 000 000 
000 000 000 000 000 000 000 000 000 000 047 000 000 056 057 053 000 000 000 000 000 000 000 000 038 038 038 000 000 000 055 074 000 000 000 000 000 000 000 000 000 045 000 000 000 000 000 000 000 000 
000 000 000 000 000 000 000 000 000 000 047 000 000 072 073 056 053 000 000 000 000 000 000 000 000 000 000 000 000 055 074 000 000 000 000 000 000 000 000 000 000 045 000 000 000 000 000 000 000 000 
000 000 000 000 000 000 000 054 054 054 055 000 000 000 000 072 056 053 000 000 000 000 000 000 000 000 000 054 055 074 000 000 000 000 000 000 037 039 000 000 000 045 000 000 000 000 000 000 000 000 
000 000 000 000 000 054 055 057 057 057 058 000 000 000 000 000 072 073 053 054 054 054 054 054 054 054 055 073 074 000 000 000 000 000 000 037 000 047 000 000 000 045 000 000 000 000 000 000 000 000 
000 000 000 000 055 057 058 073 073 073 074 000 000 000 000 000 000 000 072 073 073 073 073 073 073 073 074 000 000 000 000 000 000 037 038 000 000 047 000 000 000 053 000 000 000 000 000 000 000 000 
000 000 000 047 058 073 074 000 000 000 000 000 000 037 038 039 000 000 000 000 000 000 000 000 000 000 000 000 000 000 000 000 037 000 000 000 000 047 000 000 000 072 053 054 054 000 000 000 000 000 
000 014 000 047 074 000 000 000 000 000 000 037 038 000 000 000 038 038 038 038 038 038 038 038 038 038 038 038 038 038 038 038 000 000 000 000 000 047 000 000 000 000 072 073 070 000 000 000 000 000 
000 000 000 047 000 000 000 000 037 038 038 000 000 000 000 000 000 000 000 000 000 000 000 000 000 000 000 000 000 000 000 001 000 000 000 000 000 047 000 007 000 000 000 072 078 000 000 000 000 000 
000 000 000 047 000 000 037 038 000 000 000 000 000 000 000 000 000 000 000 000 000 000 000 000 000 000 000 000 000 007 000 000 000 000 000 000 000 047 000 000 000 000 000 000 000 045 000 000 000 000 
000 000 000 000 038 038 000 000 000 000 000 000 000 000 000 000 000 000 000 000 000 000 014 000 000 000 000 000 000 000 000 000 000 000 000 000 000 047 000 000 000 000 000 000 000 045 000 000 000 000 
000 000 001 000 000 000 000 000 000 007 000 000 000 000 000 000 000 007 000 000 000 000 000 000 000 000 000 000 000 000 000 000 000 000 000 000 014 000 039 000 000 000 000 000 000 045 000 000 000 000 
000 000 000 000 000 000 000 000 000 000 000 000 000 000 000 000 000 000 000 000 000 000 000 000 000 000 000 000 000 000 000 000 000 000 007 000 000 000 000 047 000 000 000 000 000 045 000 000 000 000 
