041 041 041 041 041 041 041 041 041 041 041 041 041 041 041 041 041 041 041 041 041 041 041 041 041 041 041 041 041 041 041 041 041 041 041 041 041 041 041 041 041 041 041 041 041 041 041 041 041 041 
041 041 041 041 041 041 041 041 041 041 041 041 041 041 041 041 041 041 041 041 041 041 041 041 041 041 037 038 038 038 038 038 038 038 038 038 038 038 038 038 038 038 038 039 041 041 041 041 041 041 
041 041 041 041 041 041 041 041 041 041 041 041 041 041 041 041 041 041 041 041 041 041 041 041 041 041 045 021 000 000 000 000 021 000 000 000 000 021 000 000 000 000 021 047 041 041 041 041 041 041 
041 041 041 041 041 041 041 041 041 041 041 041 041 041 041 041 041 041 041 041 041 041 041 041 041 041 045 029 000 000 000 000 029 000 000 000 000 029 000 000 000 000 029 047 041 041 041 041 041 041 
041 041 041 041 041 041 041 041 041 041 041 041 041 041 041 041 041 041 041 041 041 041 041 041 041 041 045 000 000 000 000 000 000 000 000 000 000 000 000 000 000 000 000 047 041 041 041 041 041 041 
041 041 041 041 041 041 041 041 041 041 041 041 041 041 041 041 041 041 041 041 041 041 041 041 041 037 000 000 000 000 000 000 000 000 000 000 000 000 000 000 000 000 000 047 041 041 041 041 041 041 
041 041 041 041 041 041 041 041 041 041 041 041 041 041 041 041 041 041 041 041 041 041 037 038 038 000 000 000 000 000 000 000 000 000 000 000 000 000 000 000 000 000 000 047 041 041 041 041 041 041 
041 041 041 041 041 041 041 041 041 041 041 041 041 041 041 041 037 038 038 038 038 038 000 021 000 000 000 000 000 000 000 000 000 000 000 000 000 000 000 000 000 000 000 047 041 041 041 041 041 041 
041 041 041 041 041 041 041 041 041 041 041 041 041 041 041 041 045 000 000 021 000 000 000 029 000 000 000 000 000 000 000 000 000 000 000 000 000 000 000 000 000 000 000 047 041 041 041 041 041 041 
041 041 041 041 041 041 041 041 041 041 041 041 041 041 041 037 000 000 000 029 000 000 000 000 000 000 000 000 000 000 000 000 000 000 000 000 000 000 000 000 000 000 000 047 041 041 041 041 041 041 
038 038 038 038 038 038 038 038 038 038 038 038 038 038 038 000 000 000 000 000 000 000 000 000 000 000 000 000 000 000 000 000 000 000 000 000 000 000 000 000 000 000 000 047 041 041 041 041 041 041 
000 000 000 000 000 000 000 000 000 000 000 000 000 000 000 000 000 000 000 000 000 000 000 000 000 000 000 000 000 000 000 000 000 000 000 000 000 000 000 000 000 000 263 047 041 041 041 041 041 041 
054 054 054 054 054 054 054 054 054 054 054 054 054 054 054 000 000 000 000 000 000 000 000 000 000 000 000 000 000 000 000 000 000 000 000 000 000 000 000 000 000 000 000 047 041 041 041 041 041 041 
105 105 105 105 105 105 105 105 105 105 105 105 105 105 105 053 000 000 000 021 000 000 000 000 000 000 000 000 000 000 000 000 000 000 000 000 000 000 000 000 000 000 000 047 041 041 041 041 041 041 
113 113 113 113 113 113 113 113 113 113 113 113 113 113 113 104 045 000 000 029 000 000 000 021 000 000 000 000 000 000 000 000 000 000 000 000 000 000 000 000 000 000 000 047 041 041 041 041 041 041 
121 121 121 121 121 121 121 121 121 121 121 121 121 121 121 112 053 054 054 054 054 054 000 029 000 000 000 000 000 000 000 000 000 000 000 000 000 000 000 000 000 000 000 047 041 041 041 041 041 041 
129 129 129 129 129 129 129 129 129 129 129 129 129 129 129 120 104 105 105 105 105 105 053 054 054 000 000 000 000 000 000 000 000 000 000 000 000 000 000 000 000 000 000 047 041 041 041 041 041 041 
137 137 137 137 137 137 137 137 137 137 137 137 137 137 137 128 112 113 113 113 113 113 104 105 105 053 000 000 000 000 000 000 000 000 000 000 000 000 000 000 000 000 000 047 041 041 041 041 041 041 
145 145 145 145 145 145 145 145 145 145 145 145 145 145 145 136 120 121 121 121 121 121 112 113 113 104 045 000 000 000 000 000 000 000 000 000 000 000 000 000 000 000 000 047 041 041 041 041 041 041 
041 041 041 041 041 041 041 041 041 041 041 041 041 041 041 144 128 129 129 129 129 129 120 121 121 112 045 021 000 000 000 000 021 000 000 000 000 021 000 000 000 000 021 047 041 041 041 041 041 041 
041 041 041 041 041 041 041 041 041 041 041 041 041 041 041 041 136 137 137 137 137 137 128 129 129 120 045 029 000 000 000 000 029 000 000 000 000 029 000 000 000 000 029 047 041 041 041 041 041 041 
041 041 041 041 041 041 041 041 041 041 041 041 041 041 041 041 144 145 145 145 145 145 136 137 137 128 053 054 054 054 054 054 054 054 054 054 054 054 054 054 054 054 054 055 041 041 041 041 041 041 
041 041 041 041 041 041 041 041 041 041 041 041 041 041 041 041 041 041 041 041 041 041 144 145 145 136 104 105 105 105 105 105 105 105 105 105 105 105 105 105 105 105 105 106 041 041 041 041 041 041 
041 041 041 041 041 041 041 041 041 041 041 041 041 041 041 041 041 041 041 041 041 041 041 041 041 144 112 113 113 113 113 113 113 113 113 113 113 113 113 113 113 113 113 114 041 041 041 041 041 041 
041 041 041 041 041 041 041 041 041 041 041 041 041 041 041 041 041 041 041 041 041 041 041 041 041 041 120 121 121 121 121 121 121 121 121 121 121 121 121 121 121 121 121 122 041 041 041 041 041 041 
041 041 041 041 041 041 041 041 041 041 041 041 041 041 041 041 041 041 041 041 041 041 041 041 041 041 128 129 129 129 129 129 129 129 129 129 129 129 129 129 129 129 129 130 041 041 041 041 041 041 
041 041 041 041 041 041 041 041 041 041 041 041 041 041 041 041 041 041 041 041 041 041 041 041 041 041 136 137 137 137 137 137 137 137 137 137 137 137 137 137 137 137 137 138 041 041 041 041 041 041 
041 041 041 041 041 041 041 041 041 041 041 041 041 041 041 041 041 041 041 041 041 041 041 041 041 041 144 145 145 145 145 145 145 145 145 145 145 145 145 145 145 145 145 146 041 041 041 041 041 041 