009 009 009 009 009 009 009 009 009 009 009 009 009 009 009 009 009 009 009 009 009 009 009 009 009 009 009 009 009 009 009 009 009 009 009 009 009 009 009 009 009 009 009 009 009 009 009 009 009 009 
009 009 009 009 009 009 009 009 009 009 009 009 009 009 009 009 009 009 009 009 009 009 009 009 029 030 031 009 009 009 009 009 009 009 009 009 009 009 009 009 009 009 009 009 009 009 009 009 009 009 
009 009 009 009 009 009 009 009 009 009 009 009 009 009 009 009 009 009 009 009 009 009 009 009 029 030 031 009 009 009 009 009 009 009 009 009 009 009 009 009 009 009 009 009 009 009 009 009 009 009 
009 009 009 009 009 009 009 009 009 009 009 009 009 009 009 009 009 009 009 009 009 009 009 009 029 030 031 009 009 009 009 009 009 009 009 009 009 009 009 009 009 009 009 009 009 009 009 009 009 009 
009 009 009 009 009 009 009 009 009 009 009 009 009 009 009 009 009 009 009 009 009 009 009 009 029 030 031 009 009 009 009 009 009 009 009 009 009 009 009 009 009 009 009 009 009 009 009 009 009 009 
009 009 009 009 009 009 009 009 009 009 009 009 009 009 009 009 009 009 009 009 009 009 009 009 030 030 030 009 009 009 009 009 009 009 009 009 009 009 009 009 009 009 009 009 009 009 009 009 009 009 
009 009 009 009 009 009 009 009 009 009 009 009 009 009 009 009 009 009 009 009 009 009 009 030 030 030 030 030 009 009 009 009 009 009 009 009 009 009 009 009 009 009 009 009 009 009 009 009 009 009 
009 009 009 009 009 009 009 009 009 009 009 009 009 009 009 009 009 009 009 009 009 009 030 039 029 030 031 037 030 009 009 009 009 009 009 009 009 009 009 009 009 009 009 009 009 009 009 009 009 009 
009 009 009 009 009 009 009 009 009 009 009 009 009 009 009 009 009 009 009 009 009 030 039 042 029 030 031 040 037 030 009 009 009 009 009 009 009 009 009 009 009 009 009 009 009 009 009 009 009 009 
009 009 009 009 009 009 009 009 009 009 009 009 009 009 009 009 009 009 009 009 030 039 042 042 030 030 030 040 040 037 030 009 009 009 009 009 009 009 009 009 009 009 009 009 009 009 009 009 009 009 
009 022 022 022 022 022 022 022 022 022 022 022 022 022 022 022 022 022 022 030 030 042 042 030 030 030 030 030 040 040 030 030 022 022 022 022 022 022 022 022 022 022 022 022 022 022 022 022 022 009 
029 030 030 030 030 030 030 030 030 030 030 030 030 030 030 030 030 030 030 030 030 030 030 030 030 030 030 030 030 030 030 030 030 030 030 030 030 030 030 030 030 030 030 030 030 030 030 030 030 031 
037 038 038 038 038 038 038 038 038 038 038 038 038 038 038 038 038 038 038 030 030 038 038 030 030 030 030 030 038 038 030 030 038 038 038 038 038 038 038 038 038 038 038 038 038 038 038 038 038 039 
040 041 041 041 041 041 041 041 041 041 041 041 041 041 041 041 041 041 041 037 030 041 041 037 030 030 030 039 041 041 030 039 041 041 041 041 041 041 041 041 041 041 041 041 041 041 041 041 041 042 
053 054 054 054 054 054 054 054 054 054 054 054 054 054 054 054 054 054 054 041 037 030 041 040 029 030 031 042 041 030 039 042 054 054 054 054 054 054 054 054 054 054 054 054 054 054 054 054 054 055 
061 062 062 062 062 062 062 062 062 062 062 062 062 062 062 062 062 062 062 053 041 037 030 040 029 030 031 042 030 039 042 055 062 062 062 062 062 062 062 062 062 062 062 062 062 062 062 062 062 063 
069 070 070 070 070 070 070 070 070 070 070 070 070 070 070 070 070 070 070 061 053 041 037 030 030 030 030 030 039 042 055 063 070 070 070 070 070 070 070 070 070 070 070 070 070 070 070 070 070 071  
077 078 078 078 078 078 078 078 078 078 078 078 078 078 078 078 078 078 078 069 061 053 041 037 030 030 030 039 042 055 063 071 078 078 078 078 078 078 078 078 078 078 078 078 078 078 078 078 078 079 
085 086 086 086 086 086 086 086 086 086 086 086 086 086 086 086 086 086 085 077 069 061 053 041 029 030 031 042 055 063 071 079 086 086 086 086 086 086 086 086 086 086 086 086 086 086 086 086 086 087 
009 009 009 009 009 009 009 009 009 009 009 009 009 009 009 009 009 009 009 085 077 069 061 053 029 030 031 055 063 071 079 087 009 009 009 009 009 009 009 009 009 009 009 009 009 009 009 009 009 009 
009 009 009 009 009 009 009 009 009 009 009 009 009 009 009 009 009 009 009 009 085 077 069 061 029 030 031 063 071 079 087 009 009 009 009 009 009 009 009 009 009 009 009 009 009 009 009 009 009 009 
009 009 009 009 009 009 009 009 009 009 009 009 009 009 009 009 009 009 009 009 009 085 077 069 029 030 031 071 079 087 009 009 009 009 009 009 009 009 009 009 009 009 009 009 009 009 009 009 009 009 
009 009 009 009 009 009 009 009 009 009 009 009 009 009 009 009 009 009 009 009 009 009 085 077 029 030 031 079 087 009 009 009 009 009 009 009 009 009 009 009 009 009 009 009 009 009 009 009 009 009 
009 009 009 009 009 009 009 009 009 009 009 009 009 009 009 009 009 009 009 009 009 009 009 085 029 030 031 087 009 009 009 009 009 009 009 009 009 009 009 009 009 009 009 009 009 009 009 009 009 009 
009 009 009 009 009 009 009 009 009 009 009 009 009 009 009 009 009 009 009 009 009 009 009 009 029 030 031 009 009 009 009 009 009 009 009 009 009 009 009 009 009 009 009 009 009 009 009 009 009 009 
009 009 009 009 009 009 009 009 009 009 009 009 009 009 009 009 009 009 009 009 009 009 009 009 029 030 031 009 009 009 009 009 009 009 009 009 009 009 009 009 009 009 009 009 009 009 009 009 009 009 
009 009 009 009 009 009 009 009 009 009 009 009 009 009 009 009 009 009 009 009 009 009 009 009 029 030 031 009 009 009 009 009 009 009 009 009 009 009 009 009 009 009 009 009 009 009 009 009 009 009 
009 009 009 009 009 009 009 009 009 009 009 009 009 009 009 009 009 009 009 009 009 009 009 009 029 030 031 009 009 009 009 009 009 009 009 009 009 009 009 009 009 009 009 009 009 009 009 009 009 009 