009 009 009 009 009 009 009 009 009 009 009 009 009 009 009 009 009 009 009 009 009 009 009 009 021 022 023 009 009 009 009 009 009 009 009 009 009 009 009 009 009 009 009 009 009 009 009 009 009 009 
009 009 009 009 009 009 009 009 009 009 009 009 009 009 009 009 009 009 009 009 009 009 009 009 029 000 031 009 009 009 009 009 009 009 009 009 009 009 009 009 009 009 009 009 009 009 009 009 009 009 
009 009 009 009 009 009 009 009 009 009 009 009 009 009 009 009 009 009 009 009 009 009 009 009 029 000 031 009 009 009 009 009 009 009 009 009 009 009 009 009 009 009 009 009 009 009 009 009 009 009 
009 009 009 009 009 009 009 009 009 009 009 009 009 009 009 009 009 009 009 009 009 009 009 009 029 000 031 009 009 009 009 009 009 009 009 009 009 009 009 009 009 009 009 009 009 009 009 009 009 009 
009 009 009 009 009 009 009 009 009 009 009 009 009 009 009 009 009 009 009 009 009 009 009 009 029 000 031 009 009 009 009 009 009 009 009 009 009 009 009 009 009 009 009 009 009 009 009 009 009 009 
009 009 009 009 009 009 009 009 009 009 009 009 009 009 009 009 009 009 009 009 005 009 009 021 000 000 000 023 009 009 005 009 009 009 009 009 009 009 009 009 009 009 009 009 009 009 009 009 009 009 
009 009 009 009 009 009 009 009 009 009 009 009 009 009 009 009 009 009 009 009 013 009 021 000 000 000 000 000 023 009 013 009 009 009 009 009 009 009 009 009 009 009 009 009 009 009 009 009 009 009 
009 009 009 009 009 009 009 009 009 009 009 009 009 009 009 009 009 009 009 009 009 021 000 039 029 000 031 037 000 023 009 009 009 009 009 009 009 009 009 009 009 009 009 009 009 009 009 009 009 009 
009 009 009 006 009 009 009 006 009 009 009 006 009 009 009 006 009 009 009 009 021 000 039 042 029 000 031 040 037 000 023 009 009 009 009 006 009 009 009 006 009 009 009 006 009 009 009 006 009 009 
009 009 009 014 009 009 009 014 009 009 009 014 009 009 009 014 009 009 009 021 000 039 042 021 000 000 000 023 040 037 000 023 009 009 009 014 009 009 009 014 009 009 009 014 009 009 009 014 009 009 
021 022 022 022 022 022 022 022 022 022 022 022 022 022 022 022 022 022 022 000 000 022 022 000 000 007 000 000 022 022 000 000 022 022 022 022 022 022 022 022 022 022 022 022 022 022 022 022 022 023 
029 000 000 000 000 000 000 000 000 000 000 000 000 000 000 000 000 000 000 000 000 000 000 000 000 015 000 000 000 000 000 000 000 000 000 000 000 000 000 000 000 000 000 000 000 000 000 000 000 031 
037 038 038 006 038 038 038 006 038 038 038 006 038 038 038 006 038 038 038 000 000 038 038 000 000 000 000 000 038 038 000 000 038 038 038 006 038 038 038 006 038 038 038 006 038 038 038 006 038 039 
040 041 041 014 041 041 041 014 041 041 041 014 041 041 041 014 041 041 041 037 000 023 041 037 000 000 000 039 041 021 000 039 041 041 041 014 041 041 041 014 041 041 041 014 041 041 041 014 041 042 
053 054 054 054 054 054 054 054 054 054 054 054 054 054 054 054 054 054 054 041 037 000 023 040 029 000 031 042 021 000 039 042 054 054 054 054 054 054 054 054 054 054 054 054 054 054 054 054 054 055 
061 062 062 062 062 062 062 062 062 062 062 062 062 062 062 062 062 062 062 053 005 037 000 023 029 000 031 021 000 039 005 055 062 062 062 062 062 062 062 062 062 062 062 062 062 062 062 062 062 063 
069 070 070 070 070 070 070 070 070 070 070 070 070 070 070 070 070 070 070 061 013 041 037 000 000 000 000 000 039 042 013 063 070 070 070 070 070 070 070 070 070 070 070 070 070 070 070 070 070 071  
077 078 078 078 078 078 078 078 078 078 078 078 078 078 078 078 078 078 078 069 061 053 041 037 000 000 000 039 042 055 063 071 078 078 078 078 078 078 078 078 078 078 078 078 078 078 078 078 078 079 
085 086 086 086 086 086 086 086 086 086 086 086 086 086 086 086 086 086 085 077 069 061 053 041 029 000 031 042 055 063 071 079 086 086 086 086 086 086 086 086 086 086 086 086 086 086 086 086 086 087 
009 009 009 009 009 009 009 009 009 009 009 009 009 009 009 009 009 009 009 085 077 069 061 053 029 000 031 055 063 071 079 087 009 009 009 009 009 009 009 009 009 009 009 009 009 009 009 009 009 009 
009 009 009 009 009 009 009 009 009 009 009 009 009 009 009 009 009 009 009 009 085 077 069 061 029 000 031 063 071 079 087 009 009 009 009 009 009 009 009 009 009 009 009 009 009 009 009 009 009 009 
009 009 009 009 009 009 009 009 009 009 009 009 009 009 009 009 009 009 009 009 009 085 077 069 029 000 031 071 079 087 009 009 009 009 009 009 009 009 009 009 009 009 009 009 009 009 009 009 009 009 
009 009 009 009 009 009 009 009 009 009 009 009 009 009 009 009 009 009 009 009 009 009 085 077 029 000 031 079 087 009 009 009 009 009 009 009 009 009 009 009 009 009 009 009 009 009 009 009 009 009 
009 009 009 009 009 009 009 009 009 009 009 009 009 009 009 009 009 009 009 009 009 009 009 085 029 000 031 087 009 009 009 009 009 009 009 009 009 009 009 009 009 009 009 009 009 009 009 009 009 009 
009 009 009 009 009 009 009 009 009 009 009 009 009 009 009 009 009 009 009 009 009 009 009 009 029 000 031 009 009 009 009 009 009 009 009 009 009 009 009 009 009 009 009 009 009 009 009 009 009 009 
009 009 009 009 009 009 009 009 009 009 009 009 009 009 009 009 009 009 009 009 009 009 009 009 029 000 031 009 009 009 009 009 009 009 009 009 009 009 009 009 009 009 009 009 009 009 009 009 009 009 
009 009 009 009 009 009 009 009 009 009 009 009 009 009 009 009 009 009 009 009 009 009 009 009 029 000 031 009 009 009 009 009 009 009 009 009 009 009 009 009 009 009 009 009 009 009 009 009 009 009 
009 009 009 009 009 009 009 009 009 009 009 009 009 009 009 009 009 009 009 009 009 009 009 009 029 000 031 009 009 009 009 009 009 009 009 009 009 009 009 009 009 009 009 009 009 009 009 009 009 009 