041 041 041 041 041 041 041 041 041 041 041 041 041 041 041 041 037 038 038 038 038 038 038 038 038 038 038 038 038 038 038 038 038 038 039 041 041 041 041 041 041 041 041 041 041 041 041 041 041 041 
041 041 041 041 041 041 041 041 041 041 041 041 041 041 041 041 021 000 000 000 000 000 000 000 000 263 000 000 000 000 000 000 000 000 021 041 041 041 041 041 041 041 041 041 041 041 041 041 041 041 
041 041 041 041 041 041 041 041 041 041 041 041 041 041 041 041 029 000 000 021 000 000 000 000 000 000 000 000 000 000 000 021 000 000 029 041 041 041 041 041 041 041 041 041 041 041 041 041 041 041 
041 041 041 041 041 041 041 041 041 041 041 041 041 041 041 041 053 054 054 029 000 000 000 000 000 000 000 000 000 000 000 029 054 054 055 041 041 041 041 041 041 041 041 041 041 041 041 041 041 041 
041 041 041 041 041 041 041 041 041 041 041 041 041 041 041 041 104 105 105 053 000 000 000 000 000 000 000 000 000 000 000 055 105 105 106 041 041 041 041 041 041 041 041 041 041 041 041 041 041 041 
041 041 041 041 041 041 041 041 041 041 041 041 041 041 041 041 112 113 113 104 021 000 000 000 000 000 000 000 000 000 021 106 113 113 114 041 041 041 041 041 041 041 041 041 041 041 041 041 041 041 
041 041 041 041 041 041 041 041 041 041 041 041 041 041 041 041 120 121 121 112 029 000 000 000 000 000 000 000 000 000 029 114 121 121 122 041 041 041 041 041 041 041 041 041 041 041 041 041 041 041 
041 041 041 041 041 041 041 041 041 041 041 041 041 041 041 041 128 129 129 120 021 000 000 000 000 000 000 000 000 000 021 122 129 129 130 041 041 041 041 041 041 041 041 041 041 041 041 041 041 041 
041 041 041 041 041 041 041 041 041 041 041 041 041 041 041 041 136 137 137 128 029 000 000 000 000 000 000 000 000 000 029 130 137 137 138 041 041 041 041 041 041 041 041 041 041 041 041 041 041 041 
041 041 041 041 041 041 041 041 041 041 041 041 041 041 041 041 144 145 145 136 053 000 000 000 000 000 000 000 000 000 055 138 145 145 146 041 041 041 041 041 041 041 041 041 041 041 041 041 041 041 
041 041 041 041 041 041 041 041 041 041 041 041 041 041 041 041 041 041 041 144 104 021 000 000 000 000 000 000 000 021 106 146 041 041 041 041 041 041 041 041 041 041 041 041 041 041 041 041 041 041 
041 041 041 041 041 041 041 041 041 041 041 041 041 041 041 041 041 041 041 041 112 029 000 000 000 000 000 000 000 029 114 041 041 041 041 041 041 041 041 041 041 041 041 041 041 041 041 041 041 041 
041 041 041 041 041 041 041 041 041 041 041 041 041 041 041 041 041 041 041 041 120 021 000 000 000 000 000 000 000 021 122 041 041 041 041 041 041 041 041 041 041 041 041 041 041 041 041 041 041 041 
041 041 041 041 041 041 041 041 041 041 041 041 041 041 041 041 041 041 041 041 128 029 000 000 000 000 000 000 000 029 130 041 041 041 041 041 041 041 041 041 041 041 041 041 041 041 041 041 041 041 
041 041 041 041 041 041 041 041 041 041 041 041 041 041 041 041 041 041 041 041 136 021 000 000 000 000 000 000 000 021 138 041 041 041 041 041 041 041 041 041 041 041 041 041 041 041 041 041 041 041 
041 041 041 041 041 041 041 041 041 041 041 041 041 041 041 041 041 041 041 041 144 029 000 021 000 000 000 021 000 029 146 041 041 041 041 041 041 041 041 041 041 041 041 041 041 041 041 041 041 041 
041 041 041 041 041 041 041 041 041 041 041 041 041 041 041 041 041 041 041 041 041 053 054 029 000 000 000 029 054 055 041 041 041 041 041 041 041 041 041 041 041 041 041 041 041 041 041 041 041 041 
041 041 041 041 041 041 041 041 041 041 041 041 041 041 041 041 041 041 041 041 041 104 105 053 000 000 000 055 105 106 041 041 041 041 041 041 041 041 041 041 041 041 041 041 041 041 041 041 041 041 
041 041 041 041 041 041 041 041 041 041 041 041 041 041 041 041 041 041 041 041 041 112 113 104 045 000 047 106 113 114 041 041 041 041 041 041 041 041 041 041 041 041 041 041 041 041 041 041 041 041 
041 041 041 041 041 041 041 041 041 041 041 041 041 041 041 041 041 041 041 041 041 120 121 112 021 000 021 114 121 122 041 041 041 041 041 041 041 041 041 041 041 041 041 041 041 041 041 041 041 041 
041 041 041 041 041 041 041 041 041 041 041 041 041 041 041 041 041 041 041 041 041 128 129 120 029 000 029 122 129 130 041 041 041 041 041 041 041 041 041 041 041 041 041 041 041 041 041 041 041 041 
041 041 041 041 041 041 041 041 041 041 041 041 041 041 041 041 041 041 041 041 041 136 137 128 021 000 021 130 137 146 041 041 041 041 041 041 041 041 041 041 041 041 041 041 041 041 041 041 041 041 
041 041 041 041 041 041 041 041 041 041 041 041 041 041 041 041 041 041 041 041 041 144 145 136 029 000 029 138 145 041 041 041 041 041 041 041 041 041 041 041 041 041 041 041 041 041 041 041 041 041 
041 041 041 041 041 041 041 041 041 041 041 041 041 041 041 041 041 041 041 041 041 041 041 144 021 000 021 146 041 041 041 041 041 041 041 041 041 041 041 041 041 041 041 041 041 041 041 041 041 041 
041 041 041 041 041 041 041 041 041 041 041 041 041 041 041 041 041 041 041 041 041 041 041 041 029 000 029 041 041 041 041 041 041 041 041 041 041 041 041 041 041 041 041 041 041 041 041 041 041 041 
041 041 041 041 041 041 041 041 041 041 041 041 041 041 041 041 041 041 041 041 041 041 041 041 021 000 021 041 041 041 041 041 041 041 041 041 041 041 041 041 041 041 041 041 041 041 041 041 041 041 
041 041 041 041 041 041 041 041 041 041 041 041 041 041 041 041 041 041 041 041 041 041 041 041 029 000 029 041 041 041 041 041 041 041 041 041 041 041 041 041 041 041 041 041 041 041 041 041 041 041 
041 041 041 041 041 041 041 041 041 041 041 041 041 041 041 041 041 041 041 041 041 041 041 041 045 000 047 041 041 041 041 041 041 041 041 041 041 041 041 041 041 041 041 041 041 041 041 041 041 041 