041 041 041 041 041 041 041 041 041 041 041 041 041 041 041 041 041 041 041 041 041 041 041 041 041 041 041 041 041 041 041 041 041 041 041 041 041 041 041 041 041 041 041 041 041 041 041 041 041 041 
041 041 041 041 041 041 041 041 041 041 041 041 041 041 041 041 045 000 000 000 000 000 000 000 000 000 000 000 000 000 000 000 000 000 047 041 041 041 041 041 041 041 041 041 041 041 041 041 041 041 
041 041 041 041 041 041 041 041 041 041 041 041 041 041 041 041 045 000 000 000 000 000 000 000 000 000 000 000 000 000 000 000 000 000 047 041 041 041 041 041 041 041 041 041 041 041 041 041 041 041 
041 041 041 041 041 041 041 041 041 041 041 041 041 041 041 041 053 054 054 000 000 000 000 000 000 000 000 000 000 000 000 000 054 054 055 041 041 041 041 041 041 041 041 041 041 041 041 041 041 041 
041 041 041 041 041 041 041 041 041 041 041 041 041 041 041 041 104 105 105 053 000 000 000 000 000 000 000 000 000 000 000 055 105 105 106 041 041 041 041 041 041 041 041 041 041 041 041 041 041 041 
041 041 041 041 041 041 041 041 041 041 041 041 041 041 041 041 112 113 113 104 045 000 000 000 000 000 000 000 000 000 047 106 113 113 114 041 041 041 041 041 041 041 041 041 041 041 041 041 041 041 
041 041 041 041 041 041 041 041 041 041 041 041 041 041 041 041 120 121 121 112 045 000 000 000 000 000 000 000 000 000 047 114 121 121 122 041 041 041 041 041 041 041 041 041 041 041 041 041 041 041 
041 041 041 041 041 041 041 041 041 041 041 041 041 041 041 041 128 129 129 120 045 000 000 000 000 000 000 000 000 000 047 122 129 129 130 041 041 041 041 041 041 041 041 041 041 041 041 041 041 041 
041 041 041 041 041 041 041 041 041 041 041 041 041 041 041 041 136 137 137 128 045 000 000 000 000 000 000 000 000 000 047 130 137 137 138 041 041 041 041 041 041 041 041 041 041 041 041 041 041 041 
041 041 041 041 041 041 041 041 041 041 041 041 041 041 041 041 144 145 145 136 053 000 000 000 000 000 000 000 000 000 055 138 145 145 146 041 041 041 041 041 041 041 041 041 041 041 041 041 041 041 
041 041 041 041 041 041 041 041 041 041 041 041 041 041 041 041 041 041 041 144 104 045 000 000 000 000 000 000 000 047 106 146 041 041 041 041 041 041 041 041 041 041 041 041 041 041 041 041 041 041 
041 041 041 041 041 041 041 041 041 041 041 041 041 041 041 041 041 041 041 041 112 045 000 000 000 000 000 000 000 047 114 041 041 041 041 041 041 041 041 041 041 041 041 041 041 041 041 041 041 041 
041 041 041 041 041 041 041 041 041 041 041 041 041 041 041 041 041 041 041 041 120 045 000 000 000 000 000 000 000 047 122 041 041 041 041 041 041 041 041 041 041 041 041 041 041 041 041 041 041 041 
041 041 041 041 041 041 041 041 041 041 041 041 041 041 041 041 041 041 041 041 128 045 000 000 000 000 000 000 000 047 130 041 041 041 041 041 041 041 041 041 041 041 041 041 041 041 041 041 041 041 
041 041 041 041 041 041 041 041 041 041 041 041 041 041 041 041 041 041 041 041 136 045 000 000 000 000 000 000 000 047 138 041 041 041 041 041 041 041 041 041 041 041 041 041 041 041 041 041 041 041 
041 041 041 041 041 041 041 041 041 041 041 041 041 041 041 041 041 041 041 041 144 045 000 000 000 000 000 000 000 047 146 041 041 041 041 041 041 041 041 041 041 041 041 041 041 041 041 041 041 041 
041 041 041 041 041 041 041 041 041 041 041 041 041 041 041 041 041 041 041 041 041 053 054 000 000 000 000 000 054 055 041 041 041 041 041 041 041 041 041 041 041 041 041 041 041 041 041 041 041 041 
041 041 041 041 041 041 041 041 041 041 041 041 041 041 041 041 041 041 041 041 041 104 105 053 000 000 000 055 105 106 041 041 041 041 041 041 041 041 041 041 041 041 041 041 041 041 041 041 041 041 
041 041 041 041 041 041 041 041 041 041 041 041 041 041 041 041 041 041 041 041 041 112 113 104 045 000 047 106 113 114 041 041 041 041 041 041 041 041 041 041 041 041 041 041 041 041 041 041 041 041 
041 041 041 041 041 041 041 041 041 041 041 041 041 041 041 041 041 041 041 041 041 120 121 112 045 000 047 114 121 122 041 041 041 041 041 041 041 041 041 041 041 041 041 041 041 041 041 041 041 041 
041 041 041 041 041 041 041 041 041 041 041 041 041 041 041 041 041 041 041 041 041 128 129 120 045 000 047 122 129 130 041 041 041 041 041 041 041 041 041 041 041 041 041 041 041 041 041 041 041 041 
041 041 041 041 041 041 041 041 041 041 041 041 041 041 041 041 041 041 041 041 041 136 137 128 045 000 047 130 137 146 041 041 041 041 041 041 041 041 041 041 041 041 041 041 041 041 041 041 041 041 
041 041 041 041 041 041 041 041 041 041 041 041 041 041 041 041 041 041 041 041 041 144 145 136 045 000 047 138 145 041 041 041 041 041 041 041 041 041 041 041 041 041 041 041 041 041 041 041 041 041 
041 041 041 041 041 041 041 041 041 041 041 041 041 041 041 041 041 041 041 041 041 041 041 144 045 000 047 146 041 041 041 041 041 041 041 041 041 041 041 041 041 041 041 041 041 041 041 041 041 041 
041 041 041 041 041 041 041 041 041 041 041 041 041 041 041 041 041 041 041 041 041 041 041 041 045 000 047 041 041 041 041 041 041 041 041 041 041 041 041 041 041 041 041 041 041 041 041 041 041 041 
041 041 041 041 041 041 041 041 041 041 041 041 041 041 041 041 041 041 041 041 041 041 041 041 045 000 047 041 041 041 041 041 041 041 041 041 041 041 041 041 041 041 041 041 041 041 041 041 041 041 
041 041 041 041 041 041 041 041 041 041 041 041 041 041 041 041 041 041 041 041 041 041 041 041 045 000 047 041 041 041 041 041 041 041 041 041 041 041 041 041 041 041 041 041 041 041 041 041 041 041 
041 041 041 041 041 041 041 041 041 041 041 041 041 041 041 041 041 041 041 041 041 041 041 041 045 000 047 041 041 041 041 041 041 041 041 041 041 041 041 041 041 041 041 041 041 041 041 041 041 041 