0779 0779 0779 0779 0779 0779 0779 0779 0779 0779 0779 0779 0779 0779 0779 0779 0779 0779 0779 0779 0779 0779 0779 0779 0779 0779 0779 0779 0779 0779 0779 0779 0779 0779 0779 0779 0779 0779 0779 0779 0779 0779 0779 0779 0779 0779 0779 0779 0779 0779 
0779 0779 0779 0779 0779 0779 0779 0779 0779 0779 0779 0779 0779 0779 0779 0779 0779 0779 0779 0779 0779 0779 0779 0779 0779 0779 0779 0779 0779 0779 0779 0779 0779 0779 0779 0779 0779 0779 0779 0779 0779 0779 0779 0779 0779 0779 0779 0779 0779 0779 
0779 0779 0779 0779 0779 0779 0779 0779 0779 0779 0779 0779 0779 0779 0779 0779 0779 0779 0779 0779 0779 0779 0779 0779 0779 0779 0779 0779 0779 0779 0779 0779 0779 0779 0779 0779 0779 0779 0779 0779 0779 0779 0779 0779 0779 0779 0779 0779 0779 0779 
0705 0705 0705 0705 0705 0705 0705 0705 0705 0705 0705 0705 0705 0705 0705 0705 0705 0705 0705 0705 0705 0705 0705 0705 0705 0705 0705 0705 0705 0705 0705 0705 0705 0705 0705 0705 0705 0705 0705 0705 0705 0705 0705 0705 0705 0705 0705 0705 0705 0705 
0705 0705 0705 0705 0705 0705 0705 0705 0705 0705 0705 0705 0705 0705 0705 0705 0705 0705 0705 0705 0705 0705 0705 0705 0705 0705 0705 0705 0705 0705 0705 0705 0705 0705 0705 0705 0705 0705 0705 0705 0705 0705 0705 0705 0705 0705 0705 0705 0705 0705 
0705 0705 0705 0705 0705 0705 0705 0705 0705 0705 0705 0705 0705 0705 0705 0705 0705 0705 0705 0705 0705 0705 0705 0705 0705 0705 0705 0705 0705 0705 0705 0705 0705 0705 0705 0705 0705 0705 0705 0705 0705 0705 0705 0705 0705 0705 0705 0705 0705 0705 
0705 0705 0705 0705 0705 0705 0705 0705 0705 0705 0705 0705 0705 0705 0705 0705 0705 0705 0705 0705 0705 0705 0705 0705 0705 0705 0705 0705 0705 0705 0705 0705 0705 0705 0705 0705 0705 0705 0705 0705 0705 0705 0705 0705 0705 0705 0705 0705 0705 0705 
0705 0705 0705 0705 0705 0705 0705 0705 0705 0705 0705 0705 0705 0705 0705 0705 0705 0705 0705 0705 0705 0705 0705 0705 0705 0705 0705 0705 0705 0705 0705 0705 0705 0705 0705 0705 0705 0705 0705 0705 0705 0705 0705 0705 0705 0705 0705 0705 0705 0705 
0779 0779 0779 0779 0779 0779 0779 0779 0779 0779 0779 0779 0779 0779 0779 0779 0779 0779 0779 0779 0779 0779 0779 0779 0779 0779 0779 0779 0779 0779 0779 0779 0779 0779 0779 0779 0779 0779 0779 0779 0779 0304 0305 0306 0469 0469 0304 0305 0306 0779 
0779 0779 0779 0779 0779 0779 0779 0779 0779 0779 0779 0779 0779 0779 0779 0779 0779 0779 0779 0779 0779 0779 0779 0779 0779 0779 0779 0779 0779 0779 0779 0779 0779 0779 0779 0779 0779 0779 0779 0779 0779 0304 0305 0306 0464 0465 0304 0305 0306 0779 
0779 0779 0779 0779 0779 0779 0779 0779 0779 0779 0779 0779 0779 0779 0779 0779 0779 0779 0779 0779 0779 0779 0779 0779 0779 0779 0779 0779 0779 0779 0779 0779 0779 0779 0779 0779 0779 0779 0779 0779 0779 0304 0305 0306 0496 0497 0304 0305 0306 0779 
0624 0624 0624 0624 0624 0624 0624 0624 0624 0624 0624 0624 0624 0624 0624 0624 0624 0624 0624 0624 0624 0624 0624 0624 0624 0624 0624 0624 0624 0624 0624 0624 0624 0624 0624 0624 0624 0624 0624 0624 0624 0624 0624 0624 0624 0624 0624 0624 0624 0624 
0624 0624 0624 0624 0624 0624 0624 0624 0624 0624 0624 0624 0624 0624 0624 0624 0624 0624 0624 0624 0624 0624 0624 0624 0624 0624 0624 0624 0624 0624 0624 0624 0624 0624 0624 0624 0624 0624 0624 0624 0624 0624 0624 0624 0624 0624 0624 0624 0624 0624 
0624 0624 0624 0624 0624 0624 0624 0624 0624 0624 0624 0624 0624 0624 0624 0624 0624 0624 0624 0624 0624 0624 0624 0624 0624 0624 0624 0624 0624 0624 0624 0624 0624 0624 0624 0624 0624 0624 0624 0624 0624 0624 0624 0624 0624 0624 0624 0624 0624 0624 
0624 0624 0624 0624 0624 0624 0624 0624 0624 0624 0624 0624 0624 0624 0624 0624 0624 0624 0624 0624 0624 0624 0624 0624 0624 0624 0624 0624 0624 0624 0624 0624 0624 0624 0624 0624 0624 0624 0624 0624 0624 0624 0624 0624 0624 0624 0624 0624 0624 0624 
0624 0624 0624 0624 0624 0624 0624 0624 0624 0624 0624 0624 0624 0624 0624 0624 0624 0624 0624 0624 0624 0624 0624 0624 0624 0624 0624 0624 0624 0624 0624 0624 0624 0624 0624 0624 0624 0624 0624 0624 0624 0624 0624 0624 0624 0624 0624 0624 0624 0624 
0624 0624 0624 0624 0624 0624 0624 0624 0624 0624 0624 0624 0624 0624 0624 0624 0624 0624 0624 0624 0624 0624 0624 0624 0624 0624 0624 0624 0624 0624 0624 0624 0624 0624 0624 0624 0624 0624 0624 0624 0624 0624 0624 0624 0624 0624 0624 0624 0624 0624 
0779 0304 0305 0306 0469 0469 0304 0305 0306 0779 0779 0779 0779 0779 0779 0779 0779 0779 0779 0779 0779 0779 0779 0779 0779 0779 0779 0779 0779 0779 0779 0779 0779 0779 0779 0779 0779 0779 0779 0779 0779 0779 0779 0779 0779 0779 0779 0779 0779 0779 
0779 0304 0305 0306 0464 0465 0304 0305 0306 0779 0779 0779 0779 0779 0779 0779 0779 0779 0779 0779 0779 0779 0779 0779 0779 0779 0779 0779 0779 0779 0779 0779 0779 0779 0779 0779 0779 0779 0779 0779 0779 0779 0779 0779 0779 0779 0779 0779 0779 0779 
0779 0304 0305 0306 0496 0497 0304 0305 0306 0779 0779 0779 0779 0779 0779 0779 0779 0779 0779 0779 0779 0779 0779 0779 0779 0779 0779 0779 0779 0779 0779 0779 0779 0779 0779 0779 0779 0779 0779 0779 0779 0779 0779 0779 0779 0779 0779 0779 0779 0779 
0530 0530 0530 0530 0530 0530 0530 0530 0530 0530 0530 0530 0530 0530 0530 0530 0530 0530 0530 0530 0530 0530 0530 0530 0530 0530 0530 0530 0530 0530 0530 0530 0530 0530 0530 0530 0530 0530 0530 0530 0530 0530 0530 0530 0530 0530 0530 0530 0530 0530 
0530 0530 0530 0530 0530 0530 0530 0530 0530 0530 0530 0530 0530 0530 0530 0530 0530 0530 0530 0530 0530 0530 0530 0530 0530 0530 0530 0530 0530 0530 0530 0530 0530 0530 0530 0530 0530 0530 0530 0530 0530 0530 0530 0530 0530 0530 0530 0530 0530 0530 
0530 0530 0530 0530 0530 0530 0530 0530 0530 0530 0530 0530 0530 0530 0530 0530 0530 0530 0530 0530 0530 0530 0530 0530 0530 0530 0530 0530 0530 0530 0530 0530 0530 0530 0530 0530 0530 0530 0530 0530 0530 0530 0530 0530 0530 0530 0530 0530 0530 0530 
0530 0530 0530 0530 0530 0530 0530 0530 0530 0530 0530 0530 0530 0530 0530 0530 0530 0530 0530 0530 0530 0530 0530 0530 0530 0530 0530 0530 0530 0530 0530 0530 0530 0530 0530 0530 0530 0530 0530 0530 0530 0530 0530 0530 0530 0530 0530 0530 0530 0530 
0530 0530 0530 0530 0530 0530 0530 0530 0530 0530 0530 0530 0530 0530 0530 0530 0530 0530 0530 0530 0530 0530 0530 0530 0530 0530 0530 0530 0530 0530 0530 0530 0530 0530 0530 0530 0530 0530 0530 0530 0530 0530 0530 0530 0530 0530 0530 0530 0530 0530 
0530 0530 0530 0530 0530 0530 0530 0530 0530 0530 0530 0530 0530 0530 0530 0530 0530 0530 0530 0530 0530 0530 0530 0530 0530 0530 0530 0530 0530 0530 0530 0530 0530 0530 0530 0530 0530 0530 0530 0530 0530 0530 0530 0530 0530 0530 0530 0530 0530 0530 
0530 0530 0530 0530 0530 0530 0530 0530 0530 0530 0530 0530 0530 0530 0530 0530 0530 0530 0530 0530 0530 0530 0530 0779 0779 0779 0530 0530 0530 0530 0530 0530 0530 0530 0530 0530 0530 0530 0530 0530 0530 0530 0530 0530 0530 0530 0530 0530 0530 0530 
0530 0530 0530 0530 0530 0530 0530 0530 0530 0530 0530 0530 0530 0530 0530 0530 0530 0530 0530 0530 0530 0530 0530 0779 0779 0779 0530 0530 0530 0530 0530 0530 0530 0530 0530 0530 0530 0530 0530 0530 0530 0530 0530 0530 0530 0530 0530 0530 0530 0530 
