0562 0562 0562 0562 0562 0562 0562 0562 0562 0562 0562 0562 0562 0562 0562 0562 0562 0562 0562 0562 0562 0562 0562 0562 0562 0562 0562 0562 0562 0562 0562 0562 0562 0562 0562 0562 0562 0562 0562 0562 0562 0562 0562 0562 0562 0562 0562 0562 0562 0562 
0562 0900 0658 0658 0658 0658 0658 0658 0658 0658 0658 0658 0658 0658 0658 0658 0658 0658 0658 0658 0658 0658 0658 0658 0658 0658 0658 0658 0658 0658 0658 0658 0658 0658 0658 0658 0658 0658 0658 0658 0658 0658 0658 0658 0658 0658 0658 0658 0658 0562 
0562 0932 0658 0658 0658 0658 0658 0658 0658 0658 0658 0658 0658 0658 0658 0658 0658 0658 0658 0658 0658 0658 0658 0658 0658 0658 0658 0658 0658 0658 0658 0658 0658 0658 0658 0658 0658 0658 0658 0658 0658 0658 0658 0658 0658 0658 0658 0658 0658 0562 
0562 0964 0328 0329 0329 0329 0329 0329 0329 0329 0329 0329 0329 0329 0329 0329 0329 0329 0329 0329 0329 0329 0329 0329 0329 0329 0329 0329 0329 0329 0329 0329 0329 0329 0329 0329 0329 0329 0329 0329 0329 0329 0329 0329 0329 0329 0329 0329 0329 0562 
0562 0000 0360 0395 0395 0395 0395 0395 0395 0395 0395 0395 0395 0395 0395 0395 0395 0395 0395 0395 0395 0395 0395 0395 0395 0395 0395 0395 0395 0395 0395 0395 0395 0395 0000 0000 0000 1136 1137 1137 1137 1137 1137 1137 1137 1138 0000 0000 0000 0562 
0562 0000 0360 0395 0491 0491 0491 0491 0491 0491 0491 0491 0491 0491 0491 0491 0491 0395 0491 0491 0491 0491 0491 0491 0491 0491 0491 0491 0491 0491 0491 0491 0491 0395 0000 0316 0000 1168 0000 0000 0000 0000 0000 0000 0000 1168 0000 0316 0000 0562 
0562 0000 0360 0395 0000 0000 0000 0000 0000 0000 0000 0000 0000 0000 0000 0000 0000 0395 0000 0000 0000 0000 0000 0000 0000 0000 0000 0000 0000 0000 0000 0000 0000 0395 0000 0000 0000 1200 0000 0000 0000 1128 0000 0000 0000 1200 0000 0000 0360 0562 
0562 0000 0360 0395 0000 0395 0395 0000 0395 0395 0395 0395 0000 0395 0395 0395 0395 0395 0395 0395 0000 0395 0395 0395 0395 0000 0395 0395 0395 0395 0395 0395 0000 0395 0000 0000 0000 0000 0000 0000 0000 1160 0000 0000 0000 0000 0000 0000 0360 0562 
0562 0000 0360 0395 0000 0395 0491 0000 1134 1135 0395 0491 0000 0491 0491 0491 0395 0491 0491 0491 0000 0395 0491 0491 0491 0000 0491 0491 0491 0491 0491 0395 0000 0395 0000 0000 0000 0000 0000 0000 0000 0000 0000 0000 0000 0000 0000 0000 0360 0562 
0562 0000 0360 0395 0000 0395 0000 0000 1166 1167 0395 0000 0000 0000 0000 0000 0395 0000 0000 0000 0000 0395 1386 0000 0000 0000 0000 0000 0000 0000 0000 0395 0000 0395 0000 0000 0000 0000 0000 0000 0000 0000 0000 0000 0000 0000 0000 0000 0360 0562 
0562 0000 0360 0395 0000 0395 0000 0000 0395 0395 0395 0395 0000 0395 0395 0395 0395 0395 0395 0000 0395 0395 0395 0395 0395 0395 0395 0395 0395 0395 0395 0395 0000 0395 0000 0000 0000 1129 0000 0000 1235 1236 1237 0000 0000 1130 0000 0000 0360 0562 
0562 0000 0360 0395 0395 0395 0395 0000 0395 0491 0491 0491 0000 0491 0491 0491 0491 0491 0395 0000 0491 0491 0491 0491 0395 0491 0491 0491 0491 0491 0491 0491 0000 0395 0000 0316 0000 1161 0000 0000 1267 1268 1269 0000 0000 1162 0000 0316 0360 0562 
0562 0000 0360 0395 0491 0491 0395 0000 0395 0000 0000 0000 0000 0000 0000 0000 0000 0000 0395 0000 0000 0000 0000 0000 0395 0000 0000 0000 0000 0000 0000 0000 0000 0395 0000 0000 0000 0000 0000 0000 1299 1300 1301 0000 0000 0000 0000 0000 0360 0562 
0562 0000 0360 0395 0000 0000 0395 0000 0395 0000 0395 0395 0395 0395 0395 0395 0395 0395 0395 0000 0395 0395 0395 0395 0395 0395 0395 0000 0395 0395 0395 0395 0000 0395 0000 0000 0000 0000 0000 0000 0000 0000 0000 0000 0000 0000 0000 0000 0360 0562 
0562 0000 0360 0395 0000 0000 0395 0000 0395 0000 0395 0491 0491 0491 0395 0491 0491 0491 0491 0000 0491 0491 0491 0491 0395 0491 0491 0000 0491 0491 0491 0395 0000 0395 0000 0000 0000 0000 0000 0000 0000 1133 0000 0000 0000 0000 0000 0000 0360 0562 
0562 0000 0360 0395 0000 0000 0395 1223 0395 0000 0395 0000 0000 0000 0395 0000 0000 0000 0000 0000 0000 0000 0000 0000 0395 0000 0000 0000 0000 0000 0000 0395 0000 0395 0000 0000 0000 0000 0000 0000 0000 1165 0000 0000 0000 0000 0000 0000 0360 0562 
0562 0000 0360 0395 0000 0000 0395 1255 0395 0000 0395 0000 0395 0000 0395 0395 0395 0395 0000 0395 0395 0395 0395 0395 0395 0395 0395 0395 0395 0395 0000 0395 0000 0395 0000 0000 0000 0000 0000 0000 0000 0000 0000 0000 0000 0000 0000 0000 0360 0562 
0562 0000 0360 0395 0395 0000 0395 0395 0395 0000 0395 0000 0395 0000 0395 0491 0491 0491 0000 0491 0491 0395 0491 0491 0491 0491 0491 0491 0491 0491 0000 0395 0000 0395 0000 1357 1358 1358 1358 1358 1359 0000 1357 1358 1358 1358 1358 1359 0360 0562 
0562 0000 0360 0395 0491 0000 0491 0491 0491 0000 0395 0000 0395 0000 0491 0000 0000 0000 0000 0000 0000 0395 0000 0000 0000 0000 0000 0000 0000 0000 0000 0395 1354 0395 0000 0329 0329 0329 0329 0329 0329 0000 0329 0329 0329 0329 0329 0329 0000 0562 
0562 0000 0360 0395 0000 0000 0000 0000 0000 0000 0395 0000 0395 0000 0000 0000 0395 0395 0395 0395 0395 0395 0395 0395 0395 0395 0395 0395 0395 0000 0395 0395 0395 0395 0000 0000 0000 0000 0000 0000 0361 0000 0361 0000 0000 0000 0000 0000 0000 0562 
0562 0000 0360 0395 0000 0395 0395 0395 0395 0395 0395 0000 0395 0000 0395 0000 0395 0491 0491 0491 1066 1067 1068 0491 0491 0491 0395 0491 0491 0000 0491 0491 0491 0491 0000 0361 0361 0361 0361 0000 0361 0000 0361 0000 0361 0361 0361 0361 0000 0562 
0562 0000 0360 0491 0000 0491 0491 0491 0491 0491 0491 0000 0395 0000 0395 0000 0395 0000 0000 0000 1098 1099 1100 0000 0000 0000 0395 0000 0000 0000 0000 0329 0329 0329 0361 0000 0000 0000 0000 0361 0361 0000 0361 0361 0000 0000 0000 0000 0361 0562 
0562 0000 0000 0000 0000 0000 0000 0000 0000 0000 0000 0000 0491 0000 0395 0000 0491 0000 0000 0000 0000 0000 0000 0000 0000 0000 0395 0395 0395 0395 0000 0361 0361 0361 0361 0000 1062 1062 0000 0361 0361 0000 0361 0361 0000 1062 1062 0000 0361 0562 
0562 1061 1062 0329 0329 0329 0329 0329 0329 0329 0329 0329 0329 0329 0491 0000 0000 0000 0000 0000 0000 0000 0000 0000 0000 0000 0491 0491 0491 0491 0000 0000 0000 0000 0000 0000 0361 0361 0000 0000 0000 0000 0000 0000 0000 0361 0361 0000 0000 0562 
0562 0000 0000 0000 0000 0000 0000 0000 0000 0000 0000 0000 0000 0000 0329 0329 0329 0329 0329 0329 0329 0329 0329 0329 0329 0329 0329 0329 0329 0329 0329 1061 1062 1062 1062 1063 0361 0361 1061 1062 1062 1060 1062 1062 1063 0361 0361 1061 1063 0562 
0562 0562 0562 0562 0562 0562 0562 0562 0562 0562 0562 0562 0562 0562 0562 0562 0562 0562 0562 0562 0562 0562 0562 0562 0562 0562 0562 0562 0562 0562 0562 0562 0562 0562 0562 0562 0562 0562 0562 0562 0562 0562 0562 0562 0562 0562 0562 0562 0562 0562 
0658 0658 0658 0658 0658 0658 0658 0658 0658 0658 0658 0658 0658 0658 0658 0658 0658 0658 0658 0658 0658 0658 0658 0658 0658 0658 0658 0658 0658 0658 0658 0658 0658 0658 0658 0658 0658 0658 0658 0658 0658 0658 0658 0658 0658 0658 0658 0658 0658 0658 
0658 0658 0658 0658 0658 0658 0658 0658 0658 0658 0658 0658 0658 0658 0658 0658 0658 0658 0658 0658 0658 0658 0658 0658 0658 0658 0658 0658 0658 0658 0658 0658 0658 0658 0658 0658 0658 0658 0658 0658 0658 0658 0658 0658 0658 0658 0658 0658 0658 0658 