0361 0361 0361 0361 0361 0361 0361 0361 0361 0361 0361 0361 0361 0361 0361 0361 0361 0361 0361 0361 0361 0361 0361 0361 0361 0361 0361 0361 0361 0361 0361 0361 0361 0361 0361 0361 0361 0361 0361 0361 0361 0361 0361 0361 0361 0361 0361 0361 0361 0361 
0361 0658 0658 0658 0658 0658 0658 0658 0658 0658 0658 0658 0658 0658 0658 0658 0658 0658 0658 0658 0658 0658 0658 0658 0658 0658 0658 0658 0658 0658 0658 0658 0658 0658 0658 0658 0658 0658 0658 0658 0658 0658 0658 0658 0658 0658 0658 0658 0658 0361 
0361 0658 0658 0658 0658 0658 0658 0658 0658 0658 0658 0658 0658 0658 0658 0658 0658 0658 0658 0658 0658 0658 0658 0658 0658 0658 0658 0658 0658 0658 0658 0658 0658 0658 0658 0658 0658 0658 0658 0658 0658 0658 0658 0658 0658 0658 0658 0658 0658 0361 
0361 1030 0328 0329 0329 0329 0329 0329 0329 0329 0329 0329 0329 0329 0329 0329 0329 0329 0329 0329 0329 0329 0329 0329 0329 0329 0329 0329 0329 0329 0329 0329 0329 0329 0329 0329 0329 0329 0329 0329 0329 0329 0329 0329 0329 0329 0329 0329 0329 0361 
0361 1030 0360 0361 0361 0361 0361 0361 0361 0361 0361 0361 0361 0361 0361 0361 0361 0361 0361 0361 0361 0361 0361 0361 0361 0361 0361 0361 0361 0361 0361 0361 0361 0361 0361 0361 0361 0361 0361 0361 0361 0361 0361 0361 0361 0361 0361 0361 0361 0361 
0361 1030 0360 0361 0361 0361 0361 0361 0361 0361 0361 0361 0361 0361 0361 0361 0361 0361 0361 0361 0361 0361 0361 0361 0361 0361 0361 0361 0361 0361 0361 0361 0361 0361 0361 0112 0112 0112 0112 0112 0112 0112 0112 0112 0112 0112 0112 0112 0361 0361 
0361 1030 0360 0361 0112 0112 0112 0112 0112 0112 0112 0112 0112 0112 0112 0112 0112 0361 0112 0112 0112 0112 0112 0112 0112 0112 0112 0112 0112 0112 0112 0112 0112 0361 0361 0112 0112 0112 0112 0112 0112 0112 0112 0112 0112 0112 0112 0112 0361 0361 
0361 1030 0360 0361 0112 0361 0361 0112 0361 0361 0361 0361 0112 0361 0361 0361 0361 0361 0361 0361 0112 0361 0361 0361 0361 0112 0361 0361 0361 0361 0361 0361 0112 0361 0361 0112 0112 0112 0112 0112 0112 0112 0112 0112 0112 0112 0112 0112 0361 0361 
0361 1030 0360 0361 0112 0361 0361 0112 0491 0491 0361 0361 0112 0361 0361 0361 0361 0361 0361 0361 0112 0361 0361 0361 0361 0112 0361 0361 0361 0361 0361 0361 0112 0361 0361 0112 0112 0112 0112 0112 0112 0112 0112 0112 0112 0112 0112 0112 0361 0361 
0361 1030 0360 0361 0112 0361 0112 0112 0112 0112 0361 0112 0112 0112 0112 0112 0361 0112 0112 0112 0112 0361 0112 0112 0112 0112 0112 0112 0112 0112 0112 0361 0112 0361 0361 0112 0112 0112 0112 0112 0112 0112 0112 0112 0112 0112 0112 0112 0361 0361 
0361 1030 0360 0361 0112 0361 0112 0112 0361 0361 0361 0361 0112 0361 0361 0361 0361 0361 0361 0112 0361 0361 0361 0361 0361 0361 0361 0361 0361 0361 0361 0361 0112 0361 0361 0112 0112 0112 0112 0112 0112 0112 0112 0112 0112 0112 0112 0112 0361 0361 
0361 1030 0360 0361 0361 0361 0361 0112 0361 0361 0361 0361 0112 0361 0361 0361 0361 0361 0361 0112 0361 0361 0361 0361 0361 0361 0361 0361 0361 0361 0361 0361 0112 0361 0361 0112 0112 0112 0112 0112 0112 0112 0112 0112 0112 0112 0112 0112 0361 0361 
0361 1030 0360 0361 0361 0361 0361 0112 0361 0112 0112 0112 0112 0112 0112 0112 0112 0112 0361 0112 0112 0112 0112 0112 0361 0112 0112 0112 0112 0112 0112 0112 0112 0361 0361 0112 0112 0112 0112 0112 0112 0112 0112 0112 0112 0112 0112 0112 0361 0361 
0361 1030 0360 0361 0112 0112 0361 0112 0361 0112 0361 0361 0361 0361 0361 0361 0361 0361 0361 0112 0361 0361 0361 0361 0361 0361 0361 0112 0361 0361 0361 0361 0112 0361 0361 0112 0112 0112 0112 0112 0112 0112 0112 0112 0112 0112 0112 0112 0361 0361 
0361 1030 0360 0361 0112 0112 0361 0112 0361 0112 0361 0361 0361 0361 0361 0361 0361 0361 0361 0112 0361 0361 0361 0361 0361 0361 0361 0112 0361 0361 0361 0361 0112 0361 0361 0112 0112 0112 0112 0112 0112 0112 0112 0112 0112 0112 0112 0112 0361 0361 
0361 1030 0360 0361 0112 0112 0361 0112 0361 0112 0361 0112 0112 0112 0361 0112 0112 0112 0112 0112 0112 0112 0112 0112 0361 0112 0112 0112 0112 0112 0112 0361 0112 0361 0361 0112 0112 0112 0112 0112 0112 0112 0112 0112 0112 0112 0112 0112 0361 0361 
0361 1030 0360 0361 0112 0112 0361 0112 0361 0112 0361 0112 0361 0112 0361 0361 0361 0361 0112 0361 0361 0361 0361 0361 0361 0361 0361 0361 0361 0361 0112 0361 0112 0361 0361 0112 0112 0112 0112 0112 0112 0112 0112 0112 0112 0112 0112 0112 0361 0361 
0361 1030 0360 0361 0361 0112 0361 0361 0361 0112 0361 0112 0361 0112 0361 0361 0361 0361 0112 0361 0361 0361 0361 0361 0361 0361 0361 0361 0361 0361 0112 0361 0112 0361 0361 0316 0112 0112 0112 0112 0112 0112 0112 0112 0112 0112 0112 0316 0361 0361 
0361 1030 0360 0361 0361 0112 0361 0361 0361 0112 0361 0112 0361 0112 0361 0112 0112 0112 0112 0112 0112 0361 0112 0112 0112 0112 0112 0112 0112 0112 0112 0361 0112 0361 0361 0361 0361 0361 0361 0361 0361 1030 0361 0361 0361 0361 0361 0361 0361 0361 
0361 1030 0360 0361 0112 0112 0112 0112 0112 0112 0361 0112 0361 0112 0112 0112 0361 0361 0361 0361 0361 0361 0361 0361 0361 0361 0361 0361 0361 0112 0361 0361 0361 0361 0361 0361 0361 0361 0361 0361 0361 1030 0361 0361 0361 0361 0361 0361 0361 0361 
0361 1030 0360 0361 0112 0361 0361 0361 0361 0361 0361 0112 0361 0112 0361 0112 0361 0361 0361 0361 0491 0491 0491 0361 0361 0361 0361 0361 0361 0112 0361 0361 0361 0361 0361 0361 0361 0361 0361 0361 0361 1030 0361 0361 0361 0361 0361 0361 0361 0361 
0361 1030 0360 0361 0112 0361 0361 0361 0361 0361 0361 0112 0361 0112 0361 0112 0361 0112 0112 0112 0112 0112 0112 0112 0112 0112 0361 0112 0112 0112 0112 0361 0361 0361 0361 1030 1030 1030 1030 0361 0361 1030 0361 0361 1030 1030 1030 1030 0361 0361 
0361 1030 1030 0112 0112 0112 0112 0112 0112 0112 0112 0112 0361 0112 0361 0112 0361 0112 0112 0112 0112 0112 0112 0112 0112 0112 0361 0361 0361 0361 0112 0361 0361 0361 0361 1030 0361 0361 1030 0361 0361 1030 0361 0361 1030 0361 0361 1030 0361 0361 
0361 0361 0361 0361 0361 0361 0361 0361 0361 0361 0361 0361 0361 0361 0361 0112 0112 0112 0112 0112 0112 0112 0112 0112 0112 0112 0361 0361 0361 0361 0112 1030 1030 1030 1030 1030 0361 0361 1030 1030 1030 1030 1030 1030 1030 0361 0361 1030 1030 0361 
0361 0361 0361 0361 0361 0361 0361 0361 0361 0361 0361 0361 0361 0361 0361 0361 0361 0361 0361 0361 0361 0361 0361 0361 0361 0361 0361 0361 0361 0361 0361 0361 0361 0361 0361 0361 0361 0361 0361 0361 0361 0361 0361 0361 0361 0361 0361 0361 0361 0361 
0361 0361 0361 0361 0361 0361 0361 0361 0361 0361 0361 0361 0361 0361 0361 0361 0361 0361 0361 0361 0361 0361 0361 0361 0361 0361 0361 0361 0361 0361 0361 0361 0361 0361 0361 0361 0361 0361 0361 0361 0361 0361 0361 0361 0361 0361 0361 0361 0361 0361 
0658 0658 0658 0658 0658 0658 0658 0658 0658 0658 0658 0658 0658 0658 0658 0658 0658 0658 0658 0658 0658 0658 0658 0658 0658 0658 0658 0658 0658 0658 0658 0658 0658 0658 0658 0658 0658 0658 0658 0658 0658 0658 0658 0658 0658 0658 0658 0658 0658 0658 
0658 0658 0658 0658 0658 0658 0658 0658 0658 0658 0658 0658 0658 0658 0658 0658 0658 0658 0658 0658 0658 0658 0658 0658 0658 0658 0658 0658 0658 0658 0658 0658 0658 0658 0658 0658 0658 0658 0658 0658 0658 0658 0658 0658 0658 0658 0658 0658 0658 0658 