012 012 012 012 012 012 012 012 012 012 012 012 012 012 012 012 012 012 012 012 012 012 012 012 012 012 012 012 012 012 012 012 012 012 012 012 012 012 012 012 012 012 012 012 012 012 012 012 012 012 
012 012 012 012 012 012 012 012 012 012 012 012 012 012 012 012 012 012 012 012 012 012 012 012 012 012 012 012 012 012 012 012 012 012 012 012 012 012 012 012 012 012 012 012 012 012 012 012 012 012 
012 012 012 012 012 012 012 012 012 012 012 012 012 012 012 012 012 012 012 012 012 012 012 012 012 012 012 012 012 012 012 012 012 012 012 012 012 012 012 012 012 012 012 012 012 012 012 012 012 012 
012 012 012 012 012 012 012 012 012 012 012 012 012 012 012 012 012 012 012 012 012 012 012 012 012 012 012 012 012 012 012 012 012 012 012 012 012 012 012 012 012 012 012 012 012 012 012 012 012 012 
012 012 012 012 012 012 012 012 012 012 012 012 012 012 012 012 012 012 012 012 012 012 012 012 012 012 012 012 012 012 012 012 012 012 012 012 012 012 012 012 012 012 012 012 012 012 012 012 012 012 
012 012 012 012 012 012 012 017 017 017 017 017 017 017 017 017 017 017 017 017 017 017 017 017 017 017 017 017 017 017 017 017 017 017 039 017 017 017 012 012 012 012 012 012 012 012 012 012 012 012 
012 012 012 012 012 012 012 017 102 000 000 000 000 000 000 000 000 035 036 037 000 000 000 000 000 092 093 092 093 017 119 000 000 000 047 000 071 017 012 012 012 012 012 012 012 012 012 012 012 012 
012 012 012 012 012 012 012 017 110 000 000 000 000 000 000 000 000 043 044 045 000 000 000 000 000 100 101 100 101 017 127 000 000 000 061 062 079 017 012 012 012 012 012 012 012 012 012 012 012 012 
012 012 012 012 012 012 012 017 000 000 000 000 000 000 000 000 000 051 052 053 000 000 000 000 000 000 000 000 000 017 135 000 000 000 000 000 087 017 012 012 012 012 012 012 012 012 012 012 012 012 
012 012 012 012 012 012 012 017 000 000 000 000 000 000 000 000 000 000 000 000 000 000 000 000 000 000 000 000 000 017 000 000 000 000 000 000 000 017 012 012 012 012 012 012 012 012 012 012 012 012 
012 012 012 012 012 012 012 017 000 000 000 000 000 000 000 000 000 000 000 000 000 000 000 000 000 000 000 000 000 017 017 017 017 000 017 017 017 017 012 012 012 012 012 012 012 012 012 012 012 012 
012 012 012 012 012 012 012 017 000 000 000 000 000 000 000 000 000 000 000 000 000 000 000 000 000 000 000 000 000 000 000 000 000 000 000 000 102 017 012 012 012 012 012 012 012 012 012 012 012 012 
012 012 012 012 012 012 012 017 000 000 000 000 000 000 000 000 000 000 000 000 000 000 000 000 000 000 000 000 000 000 000 000 000 000 000 000 110 017 012 012 012 012 012 012 012 012 012 012 012 012 
012 012 012 012 012 012 012 017 000 000 000 000 000 060 000 000 000 000 000 000 000 000 000 000 000 000 017 017 017 017 017 017 017 000 017 017 017 017 012 012 012 012 012 012 012 012 012 012 012 012 
012 012 012 012 012 012 012 017 000 000 000 000 000 068 000 000 000 000 000 000 000 000 000 000 000 000 017 160 161 162 000 000 000 000 000 069 070 017 012 012 012 012 012 012 012 012 012 012 012 012 
012 012 012 012 012 012 012 017 000 000 000 000 032 033 034 000 000 000 000 000 000 000 000 000 000 000 017 168 169 170 000 000 000 000 000 077 078 017 012 012 012 012 012 012 012 012 012 012 012 012 
012 012 012 012 012 012 012 017 000 000 000 000 040 041 042 000 000 000 000 000 000 000 000 000 000 000 017 176 177 178 000 000 000 000 000 085 086 017 012 012 012 012 012 012 012 012 012 012 012 012 
012 012 012 012 012 012 012 017 000 000 000 000 048 049 050 000 000 000 000 000 000 000 000 000 000 000 017 000 000 000 000 000 000 000 000 000 000 017 012 012 012 012 012 012 012 012 012 012 012 012 
012 012 012 012 012 012 012 017 000 000 000 000 000 076 000 000 000 000 000 000 000 000 000 000 000 000 017 000 000 000 000 000 000 000 000 000 000 017 012 012 012 012 012 012 012 012 012 012 012 012 
012 012 012 012 012 012 012 017 000 000 000 000 000 084 000 000 000 000 000 000 000 000 000 000 000 000 017 000 000 000 119 000 118 000 119 000 000 017 012 012 012 012 012 012 012 012 012 012 012 012 
012 012 012 012 012 012 012 017 102 000 000 000 000 000 000 000 000 000 000 000 000 000 000 000 000 102 017 102 000 000 127 000 126 000 127 000 102 017 012 012 012 012 012 012 012 012 012 012 012 012 
012 012 012 012 012 012 012 017 110 000 000 000 000 000 000 000 000 000 000 000 000 000 000 000 000 110 017 110 000 000 135 000 134 000 135 000 110 017 012 012 012 012 012 012 012 012 012 012 012 012 
012 012 012 012 012 012 012 017 017 017 017 017 017 017 017 017 017 017 017 000 017 017 017 017 017 017 017 017 017 017 017 017 017 017 017 017 017 017 012 012 012 012 012 012 012 012 012 012 012 012 
012 012 012 012 012 012 012 012 012 012 012 012 012 012 012 012 012 012 012 012 012 012 012 012 012 012 012 012 012 012 012 012 012 012 012 012 012 012 012 012 012 012 012 012 012 012 012 012 012 012 
012 012 012 012 012 012 012 012 012 012 012 012 012 012 012 012 012 012 012 012 012 012 012 012 012 012 012 012 012 012 012 012 012 012 012 012 012 012 012 012 012 012 012 012 012 012 012 012 012 012 
012 012 012 012 012 012 012 012 012 012 012 012 012 012 012 012 012 012 012 012 012 012 012 012 012 012 012 012 012 012 012 012 012 012 012 012 012 012 012 012 012 012 012 012 012 012 012 012 012 012 
012 012 012 012 012 012 012 012 012 012 012 012 012 012 012 012 012 012 012 012 012 012 012 012 012 012 012 012 012 012 012 012 012 012 012 012 012 012 012 012 012 012 012 012 012 012 012 012 012 012 
012 012 012 012 012 012 012 012 012 012 012 012 012 012 012 012 012 012 012 012 012 012 012 012 012 012 012 012 012 012 012 012 012 012 012 012 012 012 012 012 012 012 012 012 012 012 012 012 012 012 