041 041 041 041 041 041 041 041 041 041 041 041 041 041 041 041 041 041 041 041 041 041 041 041 041 041 041 041 041 041 041 041 041 041 041 041 041 041 041 041 041 041 041 041 041 041 041 041 041 041 
041 041 041 041 041 041 041 038 038 038 038 038 038 038 038 038 038 038 038 038 038 038 038 041 041 041 041 041 041 041 041 041 041 041 041 041 041 041 041 041 041 041 041 041 041 041 041 041 041 041 
041 041 041 041 041 041 045 046 046 046 046 046 046 046 046 046 046 046 046 046 046 046 046 047 041 041 041 041 041 041 041 041 041 041 041 041 041 041 041 041 041 041 041 041 041 041 041 041 041 041 
041 041 041 041 041 041 045 046 046 046 046 046 046 046 046 046 046 046 046 046 046 046 046 047 041 041 041 041 041 041 041 041 041 041 041 041 041 041 041 041 041 041 041 041 041 041 041 041 041 041 
041 041 041 041 041 041 045 046 046 046 046 046 046 046 046 046 046 046 046 046 046 046 046 047 041 041 041 041 041 041 041 041 041 041 041 041 041 041 041 041 041 041 041 041 041 041 041 041 041 041 
041 041 041 041 041 041 045 046 046 046 046 046 046 046 046 046 046 046 046 046 046 046 046 046 041 041 041 041 041 041 041 041 041 041 041 041 041 041 041 041 041 041 041 041 041 041 041 041 041 041 
041 041 041 041 041 041 045 046 046 046 046 046 046 046 046 046 046 046 046 046 046 046 046 046 046 038 038 041 041 041 041 041 041 041 041 041 041 041 041 041 041 041 041 041 041 041 041 041 041 041 
041 041 041 041 041 041 045 046 046 046 046 046 046 046 046 046 046 046 046 046 046 046 046 046 046 046 046 046 038 038 038 038 038 041 041 041 041 041 041 041 041 041 041 041 041 041 041 041 041 041 
041 041 041 041 041 041 045 046 046 046 046 046 046 046 046 046 046 046 046 046 046 046 046 046 046 046 046 046 046 046 046 046 046 047 041 041 041 041 041 041 041 041 041 041 041 041 041 041 041 041 
041 041 041 041 041 041 045 046 046 046 046 046 046 046 046 046 046 046 046 046 046 046 046 046 046 046 046 046 046 046 046 046 046 046 041 041 041 041 041 041 041 041 041 041 041 041 041 041 041 041 
041 041 041 041 041 041 045 046 046 046 046 046 046 046 046 046 046 046 046 046 046 046 046 046 046 046 046 046 046 046 046 046 046 046 046 038 038 038 038 038 038 038 038 038 038 038 038 038 038 038  
041 041 041 041 041 041 045 046 046 046 046 046 046 046 046 046 046 046 046 046 046 046 046 046 046 046 046 046 046 046 046 046 046 046 046 046 046 046 046 046 046 046 046 046 046 046 046 046 046 046  
041 041 041 041 041 041 045 046 046 046 046 046 046 046 046 046 046 046 046 046 046 046 046 046 046 046 046 046 046 046 046 046 046 046 046 054 054 054 054 054 054 054 054 054 054 054 054 054 054 054 
041 041 041 041 041 041 045 046 046 046 046 046 046 046 046 046 046 046 046 046 046 046 046 046 046 046 046 046 046 046 046 046 046 046 055 105 105 105 105 105 105 105 105 105 105 105 105 105 105 105 
041 041 041 041 041 041 045 046 046 046 046 046 046 046 046 046 046 046 046 046 046 046 046 046 046 046 046 046 046 046 046 046 046 047 106 113 113 113 113 113 113 113 113 113 113 113 113 113 113 113 
041 041 041 041 041 041 045 046 046 046 046 046 046 046 046 046 046 046 046 046 046 046 046 046 046 046 046 046 054 054 054 054 054 055 114 121 121 121 121 121 121 121 121 121 121 121 121 121 121 121 
041 041 041 041 041 041 045 046 046 046 046 046 046 046 046 046 046 046 046 046 046 046 046 046 046 054 054 055 105 105 105 105 105 106 122 129 129 129 129 129 129 129 129 129 129 129 129 129 129 129 
041 041 041 041 041 041 045 046 046 046 046 046 046 046 046 046 046 046 046 046 046 046 046 046 055 105 105 106 113 113 113 113 113 114 130 137 137 137 137 137 137 137 137 137 137 137 137 137 137 137 
041 041 041 041 041 041 045 046 046 046 046 046 046 046 046 046 046 046 046 046 046 046 046 047 106 113 113 114 121 121 121 121 121 122 138 145 145 145 145 145 145 145 145 145 145 145 145 145 145 145 
041 041 041 041 041 041 045 046 046 046 046 046 046 046 046 046 046 046 046 046 046 046 046 047 114 121 121 122 129 129 129 129 129 130 146 041 041 041 041 041 041 041 041 041 041 041 041 041 041 041 
041 041 041 041 041 041 045 046 046 046 046 046 046 046 046 046 046 046 046 046 046 046 046 047 122 129 129 130 137 137 137 137 137 138 041 041 041 041 041 041 041 041 041 041 041 041 041 041 041 041 
041 041 041 041 041 041 053 054 054 054 054 054 054 054 054 054 054 054 054 054 054 054 054 055 130 137 137 138 145 145 145 145 145 146 041 041 041 041 041 041 041 041 041 041 041 041 041 041 041 041 
041 041 041 041 041 041 104 105 105 105 105 105 105 105 105 105 105 105 105 105 105 105 105 106 138 145 145 146 041 041 041 041 041 041 041 041 041 041 041 041 041 041 041 041 041 041 041 041 041 041 
041 041 041 041 041 041 112 113 113 113 113 113 113 113 113 113 113 113 113 113 113 113 113 114 146 041 041 041 041 041 041 041 041 041 041 041 041 041 041 041 041 041 041 041 041 041 041 041 041 041 
041 041 041 041 041 041 120 121 121 121 121 121 121 121 121 121 121 121 121 121 121 121 121 122 041 041 041 041 041 041 041 041 041 041 041 041 041 041 041 041 041 041 041 041 041 041 041 041 041 041 
041 041 041 041 041 041 128 129 129 129 129 129 129 129 129 129 129 129 129 129 129 129 129 130 041 041 041 041 041 041 041 041 041 041 041 041 041 041 041 041 041 041 041 041 041 041 041 041 041 041 
041 041 041 041 041 041 136 137 137 137 137 137 137 137 137 137 137 137 137 137 137 137 137 138 041 041 041 041 041 041 041 041 041 041 041 041 041 041 041 041 041 041 041 041 041 041 041 041 041 041 
041 041 041 041 041 041 144 145 145 145 145 145 145 145 145 145 145 145 145 145 145 145 145 146 041 041 041 041 041 041 041 041 041 041 041 041 041 041 041 041 041 041 041 041 041 041 041 041 041 041 