014 014 014 014 014 014 014 014 093 094 095 014 014 014 014 014 014 014 014 014 014 014 014 014 014 000 014 014 014 000 000 000 000 000 000 000 000 000 000 000 000 000 000 000 000 000 000 000 000 000 
014 014 014 014 014 014 014 014 101 102 103 014 014 014 014 014 014 014 014 014 014 014 014 014 014 000 014 014 014 000 000 000 000 000 000 000 000 000 000 000 000 000 000 000 000 000 000 000 000 000 
014 014 014 014 014 014 014 014 000 000 021 014 014 014 014 014 014 014 014 014 014 014 014 014 014 000 014 014 014 000 000 000 000 000 000 000 000 000 000 000 000 000 000 000 000 000 000 000 000 000 
014 014 014 014 014 014 014 014 021 000 029 014 014 014 014 014 014 014 014 014 014 014 014 014 014 000 014 014 014 000 000 000 000 000 000 000 000 000 000 000 000 000 000 000 000 000 000 000 000 000 
014 014 014 014 014 014 014 014 029 000 021 014 014 014 014 014 014 014 014 014 014 014 014 014 014 000 014 014 014 000 000 000 000 000 000 000 000 000 000 000 000 000 000 000 000 000 000 000 000 000 
014 014 014 014 014 014 014 014 021 000 029 014 014 014 014 014 014 014 014 014 014 014 014 014 014 000 000 000 000 000 000 000 000 000 000 000 000 000 000 000 000 000 000 000 000 000 000 000 000 000 
014 014 014 014 014 014 014 014 029 000 000 014 014 014 014 014 014 014 014 014 014 014 014 014 014 000 000 000 000 000 000 000 000 000 000 000 000 000 000 000 000 000 000 000 000 000 000 000 000 000 
014 014 014 014 014 014 014 014 000 000 000 014 014 014 019 020 014 014 014 014 014 014 014 014 014 000 000 000 000 000 000 000 000 000 000 000 000 000 000 000 000 000 000 000 000 000 000 000 000 000 
000 000 000 000 000 000 000 000 000 000 000 000 000 000 027 028 000 000 000 014 014 014 014 014 014 000 014 014 014 000 000 000 000 000 000 000 000 000 000 000 000 000 000 000 000 000 000 000 000 000 
000 000 000 000 000 000 000 000 000 000 000 000 000 000 000 000 000 000 000 014 014 014 014 014 014 000 014 014 014 000 000 000 000 000 000 000 000 000 000 000 000 000 000 000 000 000 000 000 000 000 
014 014 014 014 014 014 014 000 000 019 020 000 000 000 000 000 000 000 000 014 014 014 014 014 014 000 014 014 014 000 000 000 000 000 000 000 000 000 000 000 000 000 000 000 000 000 000 000 000 000 
014 014 014 014 014 014 014 000 000 027 028 014 014 014 014 000 000 000 000 000 000 000 000 000 000 000 014 014 014 014 014 014 014 014 014 014 014 014 014 014 014 014 014 014 014 014 014 014 014 014 
014 014 014 014 014 014 014 000 000 000 000 000 000 000 014 014 014 000 000 000 000 000 000 000 000 000 014 014 014 014 014 014 014 014 014 014 014 014 014 014 014 014 014 014 014 014 014 014 014 014 
014 014 014 014 014 014 014 000 000 000 000 000 000 000 000 000 014 014 000 000 000 000 000 000 000 000 014 014 014 014 014 014 014 014 014 014 014 014 014 014 014 014 014 014 014 014 014 014 014 014 
014 014 014 014 014 014 014 014 014 014 014 014 014 014 014 014 014 014 014 014 014 014 014 014 014 000 000 000 000 000 000 000 000 000 000 000 000 000 000 000 000 000 000 000 000 000 000 000 000 000 
000 000 000 000 000 000 000 000 000 000 000 000 000 000 000 000 000 000 000 000 000 000 000 000 000 000 014 014 014 014 014 014 014 014 014 014 014 014 014 014 014 014 014 014 014 014 014 014 014 014 
000 000 000 000 000 000 000 000 000 000 000 000 000 000 000 000 000 000 000 000 000 000 000 000 000 000 014 014 014 014 014 014 014 014 014 014 014 014 014 014 014 014 014 014 014 014 014 014 014 014 
014 014 014 014 014 014 014 014 014 014 014 014 014 014 000 000 000 014 014 014 014 014 014 014 014 014 014 014 014 014 014 014 014 014 014 014 014 014 014 014 014 014 014 014 014 014 014 014 014 014 
014 014 014 014 014 014 014 014 014 014 014 014 014 014 000 000 000 014 014 014 014 014 014 014 014 014 014 014 014 014 014 014 014 014 014 014 014 014 014 014 014 014 014 014 014 014 014 014 014 014 
014 014 014 014 014 014 014 014 014 014 014 014 014 014 000 000 000 014 014 014 014 014 014 014 014 014 014 014 014 014 014 014 014 014 014 014 014 014 014 014 014 014 014 014 014 014 014 014 014 014 
014 014 014 014 014 014 014 014 014 014 014 014 014 014 000 000 000 014 014 014 014 014 014 014 014 014 014 014 014 014 014 014 014 014 014 014 014 014 014 014 014 014 014 014 014 014 014 014 014 014 
014 014 014 014 014 014 014 014 014 014 014 014 014 014 000 000 000 014 014 014 014 014 014 014 014 014 014 014 014 014 014 014 014 014 014 014 014 014 014 014 014 014 014 014 014 014 014 014 014 014 
014 014 014 014 014 014 014 014 014 014 014 014 014 014 000 000 000 014 014 014 014 014 014 014 014 014 014 014 014 014 014 014 014 014 014 014 014 014 014 014 014 014 014 014 014 014 014 014 014 014 
014 014 014 014 014 014 014 014 014 014 014 014 014 014 000 000 000 014 014 014 014 014 014 014 014 014 014 014 014 014 014 014 014 014 014 014 014 014 014 014 014 014 014 014 014 014 014 014 014 014 
014 014 014 014 014 014 014 014 014 014 014 014 014 014 000 000 000 014 014 014 014 014 014 014 014 014 014 014 014 014 014 014 014 014 014 014 014 014 014 014 014 014 014 014 014 014 014 014 014 014 
014 014 014 014 014 014 014 014 014 014 014 014 014 014 000 000 000 014 014 014 014 014 014 014 014 014 014 014 014 014 014 014 014 014 014 014 014 014 014 014 014 014 014 014 014 014 014 014 014 014 
014 014 014 014 014 014 014 014 014 014 014 014 014 014 000 000 000 014 014 014 014 014 014 014 014 014 014 014 014 014 014 014 014 014 014 014 014 014 014 014 014 014 014 014 014 014 014 014 014 014 
014 014 014 014 014 014 014 014 014 014 014 014 014 014 000 000 000 014 014 014 014 014 014 014 014 014 014 014 014 014 014 014 014 014 014 014 014 014 014 014 014 014 014 014 014 014 014 014 014 014 