000 000 000 000 000 000 000 000 093 094 095 000 000 000 000 000 000 000 000 000 000 000 000 000 000 
000 000 000 000 000 000 000 014 101 102 103 014 000 000 000 000 000 000 000 000 000 000 000 000 000 
000 000 000 000 000 000 000 014 000 000 021 014 000 000 000 000 000 000 000 000 000 000 000 000 000 
000 000 000 000 000 000 000 014 021 000 000 014 000 000 000 000 000 000 000 000 000 000 000 000 000 
000 000 000 000 000 000 000 014 029 000 021 014 000 000 000 000 000 000 000 000 000 000 000 000 000 
000 000 000 000 000 000 000 014 000 000 029 014 000 000 000 000 000 000 000 000 000 000 000 000 000 
000 000 000 000 000 000 000 014 021 000 000 014 000 000 000 000 000 000 000 000 000 000 000 000 000 
014 014 014 014 014 014 014 014 029 000 000 014 014 014 019 020 014 014 014 014 000 000 000 000 000 
000 000 000 000 000 000 000 000 000 000 000 000 000 000 027 028 000 000 000 014 000 000 000 000 000 
000 000 000 000 000 000 000 000 000 000 000 000 000 000 000 000 000 000 000 014 000 000 000 000 000 
014 014 014 014 014 014 014 014 000 019 020 014 014 014 014 000 000 000 000 014 014 014 014 014 014 
000 000 000 000 000 000 000 014 000 027 028 000 000 000 014 014 014 000 000 000 000 000 000 000 000 
000 000 000 000 000 000 000 014 000 000 000 000 000 000 000 000 014 014 000 000 000 000 000 000 014 
000 000 000 000 000 000 000 014 000 000 000 000 000 000 000 000 000 014 014 014 014 014 014 014 014 