150 000 000 000 000 000 000 000 000 000 000 000 000 000 182 183 000 000 000 000 000 000 000 088 089 090 150 000 000 000 000 000 000 000 000 000 000 000 000 000 000 000 000 000 024 025 026 000 000 000 
150 000 000 000 000 000 000 000 000 000 000 000 000 000 190 191 000 000 000 000 000 000 000 096 097 098 150 000 000 000 000 000 000 000 000 000 000 000 000 000 000 000 000 000 032 033 034 059 059 059 
150 128 129 130 131 132 133 000 000 000 000 000 000 000 000 000 000 000 000 000 000 000 000 104 105 106 150 000 000 000 000 000 000 000 000 000 000 000 000 000 000 000 000 000 040 041 042 059 059 059 
150 136 137 138 139 140 141 000 000 010 000 000 000 000 000 000 000 000 002 000 000 000 000 112 113 114 150 000 000 000 000 000 000 000 000 000 000 000 000 000 000 000 000 000 045 046 047 059 059 059 
150 144 145 146 147 148 149 000 000 000 000 000 002 000 000 000 000 000 000 000 000 000 000 120 121 122 150 000 000 000 000 000 000 000 000 000 000 000 000 000 002 000 000 000 053 054 055 000 000 000 
150 152 153 154 155 156 157 000 000 000 000 000 000 000 000 000 000 000 000 000 000 000 000 000 000 000 150 000 002 000 000 000 000 000 000 000 000 000 000 000 000 000 000 000 061 062 063 000 000 000 
158 160 161 162 163 164 165 000 000 000 000 000 000 000 000 000 000 000 000 000 000 000 000 000 000 000 150 016 017 018 000 000 000 000 010 000 000 000 000 000 000 000 000 000 069 070 071 000 000 000 
150 168 169 170 171 172 173 000 000 000 000 000 000 000 000 000 000 000 000 000 000 002 000 000 000 000 150 024 025 026 000 000 000 000 000 000 000 000 000 000 000 000 000 000 077 078 079 000 000 000 
150 176 177 178 179 180 181 000 000 000 006 007 000 000 000 000 000 006 007 000 000 000 000 000 000 000 150 032 033 034 000 000 000 000 000 000 000 002 000 000 000 000 000 000 000 000 000 000 000 000 
150 184 185 186 187 188 189 000 000 000 014 015 000 000 000 000 000 014 015 000 000 000 000 000 000 000 150 040 041 042 000 000 000 000 000 000 000 000 000 000 000 000 000 000 060 000 000 000 000 000 
150 192 193 000 000 194 195 000 000 000 000 000 000 000 000 000 000 000 000 000 000 000 000 000 000 000 150 059 059 059 059 000 000 000 059 059 059 059 059 059 059 059 059 059 059 059 059 059 059 059  
150 200 201 000 000 202 203 000 000 000 000 000 000 000 000 000 000 000 000 000 010 000 000 000 000 000 150 000 000 000 000 000 000 000 000 000 000 000 000 000 000 000 000 000 000 000 000 000 000 000 
150 208 209 000 000 210 211 000 000 000 000 000 000 000 086 000 000 000 000 000 000 000 000 000 000 000 150 000 000 000 000 000 000 000 000 000 000 000 000 000 000 000 000 000 000 000 000 000 000 000 
150 000 000 000 000 000 000 000 000 000 000 000 000 000 094 000 000 000 000 000 000 000 000 000 000 000 150 000 002 000 000 000 000 002 000 000 000 000 000 000 000 000 000 000 000 000 000 000 000 000 
150 000 000 000 000 000 000 000 000 000 000 000 000 000 102 000 000 000 000 000 000 000 000 000 000 000 150 000 000 000 000 000 000 000 000 000 000 000 000 000 000 000 000 000 002 000 000 000 000 000 
150 000 091 000 000 091 000 000 000 000 006 007 000 000 000 000 000 006 007 000 000 000 000 000 000 000 150 000 000 000 000 000 000 000 000 000 010 000 000 000 000 000 000 000 000 000 000 000 000 000 
150 000 000 092 093 000 000 000 000 000 014 015 000 000 000 000 000 014 015 000 000 000 000 000 000 000 150 000 000 000 000 000 000 000 000 000 000 002 000 000 000 000 000 000 000 000 002 000 000 000 
150 000 000 100 101 000 000 000 000 000 000 000 000 000 000 000 000 000 000 000 000 000 000 000 000 000 005 000 000 000 060 000 000 060 000 000 000 060 000 060 000 000 000 000 000 000 000 000 000 000 
150 000 091 000 000 091 000 000 000 000 000 000 000 002 000 000 000 000 000 000 000 000 000 000 000 000 013 059 059 059 059 059 059 059 059 059 059 059 059 059 059 059 059 059 059 000 000 000 059 059 
150 000 000 000 000 000 000 000 000 000 000 000 000 000 000 000 000 000 000 000 000 000 000 000 000 000 000 000 000 000 000 056 057 058 000 000 000 000 000 000 000 000 000 000 000 000 000 000 000 000 
150 000 000 000 000 000 000 000 000 000 000 000 000 000 000 000 000 000 000 000 000 000 000 000 000 000 005 000 000 000 000 000 000 000 000 000 000 000 000 000 000 000 000 000 000 000 000 000 000 000 
150 000 000 000 000 000 000 000 000 002 000 000 000 000 000 000 000 000 010 000 000 000 000 000 000 000 013 000 000 000 000 000 000 000 000 000 000 000 002 000 000 000 000 000 000 000 000 000 002 000 
150 088 089 090 000 000 000 000 000 000 000 000 000 000 000 000 000 000 000 000 000 000 000 000 000 000 150 000 000 000 000 000 000 000 000 000 000 000 000 000 000 010 000 000 000 000 000 000 000 000 
150 096 097 098 000 000 000 000 000 000 000 000 000 000 000 000 000 000 000 000 000 000 002 000 000 000 150 000 000 000 000 000 000 000 000 000 000 000 000 000 000 000 000 000 000 000 000 000 000 000 
150 104 105 106 000 000 010 000 000 000 000 000 000 000 000 000 000 000 000 000 000 000 000 000 087 000 150 000 000 000 000 000 000 000 000 000 010 000 000 000 000 000 000 000 010 000 000 000 000 000 
150 112 113 114 000 000 000 000 000 000 000 000 000 107 108 109 000 000 000 000 000 000 000 000 095 000 150 000 000 000 000 000 000 000 000 000 000 000 000 002 000 000 000 000 000 000 000 000 000 000  
150 120 121 122 000 000 000 000 000 000 000 000 000 115 116 117 000 000 000 000 000 000 000 000 103 000 150 000 000 000 000 000 000 000 000 000 000 000 000 000 000 000 000 000 000 000 000 000 000 000  
150 150 150 150 150 150 150 150 150 150 150 150 150 125 123 124 150 150 150 150 150 150 150 150 150 150 150 000 000 000 000 000 000 000 000 000 000 000 000 000 000 000 000 000 000 000 002 000 000 000 