084 084 084 084 084 084 084 084 084 084 084 084 084 001 084 084 084 084 084 084 084 084 084 084 084 084 084 084 084 084 084 084 084 084 084 084 084 084 047 000 000 000 045 084 084 084 084 084 084 084 
084 084 084 084 084 084 084 084 084 084 084 084 084 084 084 084 084 084 084 084 084 084 084 084 084 084 084 084 084 084 014 084 084 084 007 084 084 084 055 000 000 000 045 084 084 084 084 084 084 084 
084 007 084 084 084 084 084 084 084 084 084 084 084 084 084 084 084 084 084 084 084 084 084 084 084 084 084 084 084 084 084 084 084 084 084 084 084 055 064 000 000 000 045 084 014 084 084 084 084 084 
084 084 084 084 084 084 084 084 084 084 084 084 084 084 084 084 084 084 084 084 084 084 084 084 084 084 084 084 084 084 084 084 084 084 084 084 047 064 074 000 000 000 045 084 084 084 084 084 084 084 
084 084 084 084 084 084 084 084 084 084 084 084 007 084 084 084 084 084 084 084 084 084 084 054 054 054 054 054 054 054 054 054 054 054 054 054 055 074 000 000 000 000 045 084 084 084 084 084 084 084 
084 084 084 084 084 084 084 084 084 084 084 084 084 084 084 084 084 084 084 084 084 054 055 057 057 057 057 057 057 057 057 057 057 057 057 057 058 000 000 000 000 000 045 084 084 084 084 084 084 084 
084 084 084 084 084 084 084 084 084 084 084 084 084 084 084 084 084 084 084 054 055 057 058 073 073 073 073 073 073 073 073 073 073 073 073 073 074 000 000 000 000 037 084 084 084 084 084 084 084 084 
001 084 084 084 084 084 084 084 084 084 084 084 084 084 084 084 054 054 055 057 058 073 074 000 000 000 000 000 000 000 000 000 000 000 000 000 000 000 000 000 037 084 084 084 084 084 084 084 084 084 
084 084 084 084 084 084 084 084 084 084 084 084 084 084 054 055 057 057 058 073 074 000 000 000 000 000 037 038 038 038 038 038 038 038 038 038 038 038 038 038 084 084 084 084 084 084 084 084 084 084 
084 084 084 084 084 084 084 084 084 084 084 084 054 055 073 073 073 073 074 000 000 000 000 037 038 037 084 084 084 084 084 084 084 084 084 084 084 084 084 084 084 084 084 084 084 084 084 084 084 084 
084 084 084 001 084 084 084 084 084 084 084 055 073 074 000 000 000 000 000 000 000 001 000 045 084 084 084 084 084 084 084 084 084 001 084 084 084 084 084 084 054 054 054 084 084 084 084 084 084 084  
084 084 084 084 084 084 084 084 084 084 047 058 000 000 000 000 000 000 037 039 000 000 000 053 054 084 084 084 084 084 007 084 084 084 084 084 084 084 084 055 073 073 073 045 084 084 084 084 084 084 
084 084 084 084 084 084 084 084 084 084 047 074 000 037 038 038 038 038 084 084 039 000 000 072 057 053 054 084 084 084 084 084 084 084 084 084 084 084 055 074 000 000 000 045 084 084 084 084 084 084 
084 084 084 084 084 084 084 084 084 084 047 000 000 045 084 084 084 084 084 084 084 039 000 000 000 056 057 045 084 084 084 084 084 084 084 054 054 055 074 000 000 000 037 084 084 084 084 084 084 084 
084 084 084 084 084 084 084 014 084 084 047 000 000 045 084 084 084 084 084 084 084 084 039 000 000 072 073 045 084 084 084 084 054 054 055 073 073 074 000 000 000 045 084 084 084 084 084 084 084 084 
084 084 084 084 084 084 084 084 084 084 047 000 000 053 054 084 014 084 084 084 084 084 084 039 000 000 000 045 084 084 084 055 073 073 074 000 000 000 000 000 000 045 084 084 001 084 084 084 084 084 
084 084 084 084 084 084 084 084 084 084 047 000 000 056 057 053 084 084 084 084 084 084 084 084 038 038 038 084 084 084 055 074 000 000 000 000 000 000 000 000 000 045 084 084 084 084 084 084 084 084 
084 084 084 084 084 084 084 084 084 084 047 000 000 072 073 056 053 084 084 084 084 084 084 084 084 084 084 084 084 055 074 000 000 000 000 000 000 000 000 000 000 045 084 084 084 084 084 084 084 084 
084 084 084 084 084 084 084 054 054 054 055 000 000 000 000 072 056 053 084 084 084 084 084 084 084 084 084 054 055 074 000 000 000 000 000 000 037 039 000 000 000 045 084 084 084 084 084 084 084 084 
084 084 084 084 084 054 055 057 057 057 058 000 000 000 000 000 072 073 053 054 054 054 054 054 054 054 055 073 074 000 000 000 000 000 000 037 084 047 000 000 000 045 084 084 084 084 084 084 084 084 
084 084 084 084 055 057 058 073 073 073 074 000 000 000 000 000 000 000 072 073 073 073 073 073 073 073 074 000 000 000 000 000 000 037 038 084 084 047 000 000 000 053 084 084 084 084 084 084 084 084 
084 084 084 047 058 073 074 000 000 000 000 000 000 037 038 039 000 000 000 000 000 000 000 000 000 000 000 000 000 000 000 000 037 084 084 084 084 047 000 000 000 072 053 054 054 084 084 084 084 084 
084 014 084 047 074 000 000 000 000 000 000 037 038 084 084 084 038 038 038 038 038 038 038 038 038 038 038 038 038 038 038 038 084 084 084 084 084 047 000 000 000 000 072 073 070 084 084 084 084 084 
084 084 084 047 000 000 000 000 037 038 038 084 084 084 084 084 084 084 084 084 084 084 084 084 084 084 084 084 084 084 084 001 084 084 084 084 084 047 000 007 000 000 000 072 078 084 084 084 084 084 
084 084 084 047 000 000 037 038 084 084 084 084 084 084 084 084 084 084 084 084 084 084 084 084 084 084 084 084 084 007 084 084 084 084 084 084 084 047 000 000 000 000 000 000 000 045 084 084 084 084 
084 084 084 084 038 038 084 084 084 084 084 084 084 084 084 084 084 084 084 084 084 084 014 084 084 084 084 084 084 084 084 084 084 084 084 084 084 047 000 000 000 000 000 000 000 045 084 084 084 084 
084 084 001 084 084 084 084 084 084 007 084 084 084 084 084 084 084 007 084 084 084 084 084 084 084 084 084 084 084 084 084 084 084 084 084 084 014 047 000 000 000 000 000 000 000 045 084 084 084 084 
084 084 084 084 084 084 084 084 084 084 084 084 084 084 084 084 084 084 084 084 084 084 084 084 084 084 084 084 084 084 084 084 084 084 007 084 084 084 038 038 038 038 038 038 038 084 084 084 084 084 
