001 001 001 001 001 001 001 001 001 001 001 001 001 001 001 001 001 001 001 001 001 001 001 001 001 001 001 001 001 001 001 001 001 001 001 001 001 001 001 001 001 001 001 001 001 001 001 001 001 001 
001 001 001 001 001 001 001 001 001 001 001 001 001 001 001 001 001 001 001 001 001 001 001 001 001 001 001 001 001 001 001 001 001 001 001 001 001 001 001 001 001 001 001 001 001 001 001 001 001 001 
001 001 001 001 001 001 001 001 001 001 001 001 001 001 001 001 001 001 004 004 004 004 004 004 004 004 004 004 004 004 004 001 001 001 001 001 001 001 001 001 001 001 001 001 001 001 001 001 001 001 
001 001 001 001 001 001 001 001 001 001 001 001 001 001 001 001 001 004 004 012 012 012 012 012 012 012 012 012 012 012 004 004 001 001 001 001 001 001 001 001 001 001 001 001 001 001 001 001 001 001 
001 001 001 001 001 001 001 001 001 001 001 001 001 001 001 001 001 004 061 012 012 012 012 012 012 012 012 012 012 012 060 004 001 001 001 001 001 001 001 001 001 001 001 001 001 001 001 001 001 001 
001 001 001 001 001 001 001 001 001 001 001 001 001 001 001 001 001 004 061 012 012 012 012 012 012 012 012 012 012 012 060 004 001 001 001 001 001 001 001 001 001 001 001 001 001 001 001 001 001 001 
001 001 001 001 001 001 001 001 001 001 001 001 001 001 001 001 001 004 061 003 040 005 005 005 005 005 005 005 041 003 060 004 001 001 001 001 001 001 001 001 001 001 001 001 001 001 001 001 001 001 
001 001 001 001 001 001 001 001 001 001 001 001 001 001 001 001 001 004 003 003 032 008 008 008 008 008 008 008 033 003 003 004 001 001 001 001 001 001 001 001 001 001 001 001 001 001 001 001 001 001 
001 001 001 001 001 001 001 001 001 001 001 001 001 001 001 001 001 004 003 003 032 008 008 008 008 008 008 008 033 003 003 004 001 001 001 001 001 001 001 001 001 001 001 001 001 001 001 001 001 001 
001 001 001 001 001 001 001 001 001 001 001 001 001 001 001 001 001 004 003 003 032 008 008 008 008 008 008 008 033 003 003 004 001 001 001 001 001 001 001 001 001 001 001 001 001 001 001 001 001 001 
001 001 001 001 001 001 001 001 001 001 001 001 001 001 001 001 001 004 003 003 048 013 034 008 008 008 035 013 049 003 003 004 001 001 001 001 001 001 001 001 001 001 001 001 001 001 001 001 001 001 
001 001 001 001 001 001 001 001 001 001 001 001 001 001 001 001 001 004 003 003 003 003 032 008 008 008 033 003 003 003 003 004 001 001 001 001 001 001 001 001 001 001 001 001 001 001 001 001 001 001 
001 001 001 001 001 001 001 001 001 001 001 001 001 001 001 001 001 004 003 003 003 003 032 008 008 008 033 003 003 003 003 004 001 001 001 001 001 001 001 001 001 001 001 001 001 001 001 001 001 001 
001 001 001 001 001 001 001 001 001 001 001 001 001 001 001 001 001 004 003 003 003 003 032 008 008 008 033 003 003 003 003 004 001 001 001 001 001 001 001 001 001 001 001 001 001 001 001 001 001 001 
001 001 001 001 001 001 001 001 001 001 001 001 001 001 001 001 001 004 003 003 003 003 032 008 008 008 033 003 003 003 003 004 001 001 001 001 001 001 001 001 001 001 001 001 001 001 001 001 001 001 
001 001 001 001 001 001 001 001 001 001 001 001 001 001 001 001 001 004 003 003 003 003 032 008 008 008 033 003 003 003 003 004 001 001 001 001 001 001 001 001 001 001 001 001 001 001 001 001 001 001 
001 001 001 001 001 001 001 001 001 001 001 001 001 001 001 001 001 004 003 003 003 003 032 008 008 008 033 003 003 003 003 004 001 001 001 001 001 001 001 001 001 001 001 001 001 001 001 001 001 001 
001 001 001 001 001 001 001 001 001 001 001 001 001 001 001 001 001 004 003 003 003 003 032 008 008 008 033 003 003 003 003 004 001 001 001 001 001 001 001 001 001 001 001 001 001 001 001 001 001 001 
001 001 001 001 001 001 001 001 001 001 001 001 001 001 001 001 001 004 003 003 003 003 032 008 008 008 033 003 003 003 003 004 001 001 001 001 001 001 001 001 001 001 001 001 001 001 001 001 001 001 
001 001 001 001 001 001 001 001 001 001 001 001 001 001 001 001 001 004 003 003 003 003 032 008 008 008 033 003 003 003 003 004 001 001 001 001 001 001 001 001 001 001 001 001 001 001 001 001 001 001 
001 001 001 001 001 001 001 001 001 001 001 001 001 001 001 001 001 004 003 003 003 003 032 008 008 008 033 003 003 003 003 004 001 001 001 001 001 001 001 001 001 001 001 001 001 001 001 001 001 001 
001 001 001 001 001 001 001 001 001 001 001 001 001 001 001 001 001 004 009 010 010 010 010 010 010 010 010 010 010 010 011 004 001 001 001 001 001 001 001 001 001 001 001 001 001 001 001 001 001 001 
001 001 001 001 001 001 001 001 001 001 001 001 001 001 001 001 001 004 004 002 002 002 002 002 002 002 002 002 002 002 004 004 001 001 001 001 001 001 001 001 001 001 001 001 001 001 001 001 001 001 
001 001 001 001 001 001 001 001 001 001 001 001 001 001 001 001 001 101 004 004 004 004 004 004 004 004 004 004 004 004 004 101 001 001 001 001 001 001 001 001 001 001 001 001 001 001 001 001 001 001 
001 001 001 001 001 001 001 001 001 001 001 001 001 001 001 001 001 101 101 101 101 101 101 101 101 101 101 101 101 101 101 101 001 001 001 001 001 001 001 001 001 001 001 001 001 001 001 001 001 001 
001 001 001 001 001 001 001 001 001 001 001 001 001 001 001 001 001 001 101 101 101 101 101 101 101 101 101 101 101 101 101 001 001 001 001 001 001 001 001 001 001 001 001 001 001 001 001 001 001 001 
001 001 001 001 001 001 001 001 001 001 001 001 001 001 001 001 001 001 001 001 001 001 001 001 001 001 001 001 001 001 001 001 001 001 001 001 001 001 001 001 001 001 001 001 001 001 001 001 001 001 
001 001 001 001 001 001 001 001 001 001 001 001 001 001 001 001 001 001 001 001 001 001 001 001 001 001 001 001 001 001 001 001 001 001 001 001 001 001 001 001 001 001 001 001 001 001 001 001 001 001 