000 000 000 000 000 000 000 000 000 000 000 000 034 000 000 000 000 000 000 000 000 032 000 000 000 000 000 000 000 000 000 000 000 000 000 000 002 000 000 000 000 000 000 000 000 000 000 000 000 000 
000 000 000 000 000 000 000 000 000 000 000 000 034 000 000 000 000 000 000 000 000 032 000 000 000 000 000 000 000 000 000 000 000 000 000 001 000 000 000 000 000 000 000 000 000 000 000 000 000 000 
000 000 000 000 000 000 000 000 000 000 000 000 000 026 000 000 000 002 000 000 000 040 041 041 041 041 041 041 041 041 000 000 000 000 000 000 000 000 000 000 000 000 000 000 000 000 000 000 000 000 
000 000 000 000 000 000 000 000 000 000 000 000 000 034 000 000 000 000 000 000 000 072 073 073 073 073 073 073 073 073 032 000 000 000 000 000 000 000 000 000 000 000 000 000 000 000 009 000 000 000 
000 018 000 000 000 000 000 000 000 002 000 000 000 000 026 000 000 000 000 000 000 000 000 000 000 000 000 000 000 000 032 000 000 041 041 041 041 041 000 000 000 000 000 000 000 000 000 000 001 000 
000 000 018 000 000 000 000 000 000 000 000 000 000 000 034 000 000 000 000 000 000 000 000 000 000 016 000 000 000 000 040 041 042 073 073 073 073 073 040 041 000 000 000 000 000 000 000 000 000 000 
000 000 000 000 000 000 000 000 000 000 000 000 000 000 000 026 000 000 000 000 000 000 000 000 000 000 000 000 000 000 072 073 074 000 000 000 000 000 072 073 040 000 000 000 000 000 000 000 000 000 
000 000 000 000 000 000 000 000 000 000 000 000 009 000 000 034 000 000 000 000 002 000 000 000 000 000 000 000 000 000 000 000 000 000 000 000 017 000 000 000 072 040 041 041 041 041 000 000 000 000 
000 000 000 000 000 000 000 000 000 000 000 000 000 000 000 034 000 000 000 000 000 024 025 025 025 025 026 000 000 000 000 000 000 000 000 000 000 000 000 000 000 072 073 073 073 073 040 041 041 041 
000 000 000 000 000 000 000 000 000 000 000 000 000 000 000 034 000 000 000 000 024 000 000 000 000 000 000 025 025 025 025 025 026 000 000 000 000 000 000 000 000 000 000 000 000 000 072 073 073 073 
000 000 000 000 000 000 000 000 000 000 000 000 000 000 000 034 000 000 000 000 032 000 000 000 000 000 000 000 000 000 000 000 000 025 025 026 000 000 000 000 000 000 000 000 000 000 000 000 000 000 
000 000 000 000 000 000 000 000 000 000 000 000 000 000 000 000 025 026 000 000 032 000 000 000 000 000 000 000 000 000 000 000 000 000 000 000 025 025 025 026 000 000 000 000 000 000 000 000 000 000 
000 000 000 000 000 000 000 000 000 000 000 002 000 000 000 000 000 034 000 000 032 000 010 000 000 000 000 000 000 000 000 000 000 000 000 000 000 000 000 000 025 025 025 025 025 025 025 025 025 025 
000 000 000 000 000 000 000 001 000 000 000 000 000 000 010 000 000 034 000 000 032 000 000 000 000 000 000 000 000 000 000 000 000 000 000 000 000 000 000 000 000 000 000 000 000 000 000 000 000 000 
000 000 000 000 000 000 000 000 001 000 000 000 000 000 000 000 000 034 000 000 032 000 000 000 000 000 000 000 000 000 000 000 000 000 000 000 000 000 000 000 000 000 000 000 000 000 000 000 000 000 
000 000 000 000 000 000 001 000 000 000 000 000 000 000 000 000 041 042 000 000 032 000 000 000 000 000 000 002 000 000 000 000 000 000 000 000 000 000 000 000 000 000 000 000 000 000 000 000 000 000 
000 000 000 000 000 000 000 000 000 000 000 000 000 000 000 034 073 074 000 000 032 000 000 000 000 000 000 000 000 000 000 000 000 000 000 000 000 000 000 000 000 000 000 000 001 000 000 000 000 000 
000 000 000 000 000 000 000 000 000 000 000 000 000 000 000 034 000 000 000 024 000 000 000 000 000 000 000 000 000 000 041 041 041 041 041 041 041 041 041 041 041 000 000 000 000 000 000 000 000 000 
000 000 000 000 000 000 000 000 000 000 000 000 000 000 000 042 000 000 000 032 000 000 000 000 000 000 000 000 000 042 049 049 049 049 049 049 049 049 049 049 073 000 010 000 000 000 000 000 000 000 
000 000 000 000 000 000 000 000 000 000 000 000 000 000 034 074 000 000 000 032 000 000 000 000 000 000 000 000 034 048 049 049 073 073 073 073 073 073 073 073 073 000 000 000 000 000 000 000 000 000 
000 000 000 000 000 000 000 000 000 000 000 000 000 000 034 000 016 000 000 032 000 000 000 000 000 000 000 000 042 074 000 000 021 021 021 021 021 021 021 021 021 000 000 000 009 000 001 000 000 000 
000 000 000 000 000 000 000 000 000 000 000 000 000 000 034 000 000 000 000 032 000 000 000 000 000 041 041 042 074 000 000 000 000 000 000 000 000 000 000 000 023 000 000 000 000 000 000 000 000 000 
000 000 000 000 000 000 000 000 000 000 000 000 000 000 034 000 000 000 000 040 041 041 041 041 042 073 073 074 000 000 000 000 000 000 000 000 000 000 000 000 023 000 000 000 000 000 000 000 000 000 
000 000 000 000 000 000 000 000 000 000 009 000 000 000 034 000 000 000 000 072 073 073 073 073 074 000 000 000 000 000 000 000 000 000 000 000 000 000 000 000 023 000 000 000 000 000 000 000 000 000 
000 000 000 000 000 000 000 000 000 000 000 000 000 000 000 026 000 000 000 000 000 000 000 000 000 000 000 000 000 017 000 000 000 000 000 000 000 000 000 000 023 000 000 000 000 000 000 000 000 000 
010 000 000 000 000 000 000 002 000 000 000 000 000 000 000 034 000 000 000 000 000 000 000 000 000 000 000 000 000 000 000 000 000 000 000 000 000 000 000 000 023 000 000 000 000 000 000 000 000 000 
000 000 000 000 000 000 000 000 000 000 000 000 000 000 000 000 025 025 025 025 025 025 025 025 025 025 025 025 025 025 025 026 021 021 021 021 021 021 021 021 021 000 000 000 000 000 000 000 000 000 
000 000 000 000 000 000 000 000 000 000 000 001 000 000 000 000 000 000 000 000 000 000 000 000 000 000 000 000 000 000 000 000 000 000 000 000 000 000 000 000 000 000 000 000 000 000 000 000 000 000  