0683 0683 0683 0683 0683 0683 0683 0683 0683 0683 0683 0683 0683 0683 0683 0683 0683 0683 0683 0683 0683 0683 0683 0683 0683 0683 0683 0683 0683 0683 0683 0683 0683 0683 0683 0683 0683 0683 0683 0683 0683 0683 0683 0683 0683 0683 0683 0683 0683 0683 
0683 0779 0779 0779 0779 0779 0779 0779 0779 0779 0779 0779 0779 0779 0779 0008 0009 0010 0011 0779 0779 0779 0779 0408 0409 0410 0779 0779 0779 0779 0008 0009 0010 0011 0779 0779 0779 0779 0779 0779 0779 0779 0779 0779 0779 0779 0779 0779 0779 0683 
0683 0779 0779 0779 0779 0779 0779 0779 0779 0779 0779 0779 0779 0779 0779 0040 0041 0042 0043 0779 0779 0779 0779 0440 0441 0442 0779 0779 0779 0779 0040 0041 0042 0043 0779 0779 0779 0779 0779 0779 0779 0779 0779 0779 0779 0779 0779 0779 0779 0683 
0683 0000 0000 0000 0000 0000 0000 0000 0000 0000 0000 0000 0000 0000 0000 0072 0073 0074 0075 0000 0000 0000 0000 0000 0000 0000 0000 0000 0000 0000 0072 0073 0074 0075 0000 0000 0000 0000 0000 0000 0000 0000 0000 0000 0000 0000 0000 0000 0000 0683 
0683 0000 0000 0000 0000 0000 0000 0000 0000 0000 0000 0000 0000 0000 0000 0104 0105 0106 0107 0000 0000 0000 0000 0000 0000 0000 0000 0000 0000 0000 0104 0105 0106 0107 0000 0000 0000 0000 0000 0000 0000 0000 0000 0000 0000 0000 0000 0000 0000 0683 
0683 0000 0000 0000 0000 0000 0000 0000 0000 0000 0000 0000 0000 0000 0000 0000 0000 0000 0000 0000 0000 0000 0000 0000 0000 0000 0000 0000 0000 0000 0000 0000 0000 0000 0000 0000 0000 0000 0000 0000 0000 0000 0000 0000 0000 0000 0000 0000 0000 0683 
0683 0000 0000 0000 0000 0000 0000 0000 0000 0000 0000 0000 0000 0000 0000 0000 0000 0000 0000 0000 0000 0000 0000 0000 0000 0000 0000 0000 0000 0000 0000 0000 0000 0000 0000 0000 0000 0000 0000 0000 0000 0000 0000 0000 0000 0000 0000 0000 0000 0683 
0683 0000 0000 0000 0000 0000 0000 0000 0000 0000 0000 0000 0000 0000 0000 0000 0000 0000 0000 0000 0000 0000 0000 0000 0000 0000 0000 0000 0000 0000 0000 0000 0000 0000 0000 0000 0000 0000 0000 0000 0000 0000 0000 0000 0000 0000 0000 0000 0000 0683 
0683 0779 0779 0779 0779 0779 0779 0779 0779 0779 0779 0779 0779 0779 0779 0779 0779 0779 0779 0779 0779 0779 0779 0779 0779 0779 0779 0779 0779 0779 0779 0779 0779 0779 0779 0779 0779 0779 0779 0779 0779 0000 0000 0000 0000 0000 0000 0000 0000 0683 
0683 0779 0779 0779 1280 1281 1282 1283 1284 1285 0779 0132 0779 0779 0779 0779 0779 0779 0132 0779 0779 0779 0779 0194 0195 0196 0779 0779 0779 0132 0779 0779 1280 1281 1282 1283 1284 1285 0779 0132 0779 0000 0000 0000 0000 0000 0000 0000 0000 0683 
0683 0779 0779 0779 1312 1313 1314 1315 1316 1317 0779 0164 0779 0779 0779 0779 0779 0779 0164 0779 0779 0779 0779 0226 0227 0228 0779 0779 0779 0164 0779 0779 1312 1313 1314 1315 1316 1317 0779 0164 0320 0000 0000 0000 0000 0000 0000 0000 0000 0683 
0683 0000 0000 0000 1344 1345 1346 1347 1348 1349 0000 0000 0000 0000 0000 0000 0000 0000 0000 0000 0000 0000 0000 0000 0000 0000 0000 0000 0000 0000 0000 0000 1344 1345 1346 1347 1348 1349 0000 0000 0352 0000 0000 0000 0000 0000 0000 0000 0000 0683 
0683 0000 0000 0000 1376 1377 1378 1379 1380 1381 0000 0000 0000 0000 0000 0000 0000 0000 0000 0000 0000 0000 0000 0000 0000 0000 0000 0000 0000 0000 0000 0000 1376 1377 1378 1379 1380 1381 0000 0000 0000 0000 0000 0000 0000 0000 0000 0000 0000 0683 
0683 0000 0000 0000 0000 1409 1410 1411 0097 0000 0000 0000 0000 0000 0000 0000 0000 0000 0000 0000 0000 0000 0000 0000 0000 0000 0000 0000 0000 0000 0000 0000 0000 1409 1410 1411 0097 0000 0000 0000 0000 0000 0000 0000 0000 0000 0000 0000 0000 0683 
0683 0000 0000 0000 0000 0000 0000 0000 0000 0000 0000 0000 0000 0000 0000 0000 0000 0000 0000 0000 0000 0000 0000 0000 0000 0000 0000 0000 0000 0000 0000 0000 0000 0000 0000 0000 0000 0000 0000 0000 0000 0000 0000 0000 0000 0000 0000 0000 0000 0683 
0683 0000 0000 0000 0000 0000 0000 0000 0000 0000 0000 0000 0000 0000 0000 0000 0000 0000 0000 0000 0000 0000 0000 0000 0000 0000 0000 0000 0000 0000 0000 0000 0000 0000 0000 0000 0000 0000 0000 0000 0000 0000 0000 0000 0000 0000 0000 0000 0000 0683 
0683 0000 0000 0000 0000 0000 0000 0000 0000 0000 0000 0000 0000 0000 0000 0000 0000 0000 0000 0000 0000 0000 0000 0000 0000 0000 0000 0000 0000 0000 0000 0000 0000 0000 0000 0000 0000 0000 0000 0000 0000 0000 0000 0000 0000 0000 0000 0000 0000 0683 
0683 0000 0000 0000 0000 0000 0000 0000 0000 0779 0779 0779 0779 0779 0779 0779 0779 0779 0779 0779 0779 0779 0779 0779 0779 0779 0779 0779 0779 0779 0779 0779 0779 0779 0779 0779 0779 0779 0779 0779 0779 0779 0779 0779 0779 0779 0779 0779 0779 0683 
0683 0000 0000 0000 0000 0000 0000 0000 0000 0779 0779 0134 0779 0779 0779 0779 0779 0779 0134 0779 0779 0779 0779 0779 0779 0779 0779 0779 0779 0134 0779 0779 0779 0779 0779 0779 0779 0779 0779 0134 0779 0779 0779 0779 0779 0779 0779 0779 0779 0683 
0683 0000 0000 0000 0000 0000 0000 0000 0000 0323 0779 0166 0779 0779 0779 0779 0779 0779 0166 0779 0779 0779 0779 0779 0779 0779 0779 0779 0779 0166 0779 0779 0779 0779 0779 0779 0779 0779 0779 0166 0779 0779 0779 0779 0779 0779 0779 0779 0779 0683 
0683 0000 0000 0000 0000 0000 0000 0000 0000 0355 0000 0000 0000 0000 0000 0000 0000 0000 0000 0000 0000 0000 0000 0000 0000 0000 0000 0000 0000 0000 0000 0000 0000 0000 0000 0000 0000 0000 0000 0000 0000 0000 0000 0000 0000 0000 0000 0000 0000 0683 
0683 0000 0000 0000 0000 0000 0000 0000 0000 0000 0000 0000 0000 0000 0000 0000 0000 0000 0000 0000 0000 0000 0000 0000 0000 0000 0000 0000 0000 0000 0000 0000 0000 0000 0000 0000 0000 0000 0000 0000 0000 0000 0000 0000 0000 0000 0000 0000 0000 0683 
0683 0000 0000 0000 0000 0000 0000 0000 0000 0000 0000 0000 0000 0000 0000 0000 0000 0000 0000 0000 0000 0000 0000 0000 0000 0000 0000 0000 0000 0000 0000 0000 0000 0000 0000 0000 0000 0000 0000 0000 0000 0000 0000 0000 0000 1280 1281 1282 1283 0683 
0683 1280 1281 1282 1283 1284 1285 0000 0000 0000 0000 0000 0000 0000 0000 0000 0000 0000 0000 0000 0000 0000 0000 0000 0000 0000 0000 0000 0000 0000 0000 0000 0000 0000 0000 0000 0000 0000 0000 0000 0000 0000 0000 0000 0000 1312 1313 1314 1315 0683 
0683 1312 1313 1314 1315 1316 1317 0000 0000 0200 0201 0000 0000 0000 0000 0000 0000 0000 0000 0000 0000 0000 0000 0000 0000 0000 0000 0000 0000 0000 0000 0000 0000 0000 0000 0000 0000 0000 0200 0201 0000 0000 0000 0000 0000 1344 1345 1346 1347 0683 
0683 0683 0683 0683 0683 0683 0683 0683 0683 0232 0233 0683 0683 0683 0683 0683 0683 0683 0683 0683 0683 0683 0683 0683 0683 0683 0683 0683 0683 0683 0683 0683 0683 0683 0683 0683 0683 0683 0232 0233 0683 0683 0683 0683 0683 0683 0683 0683 0683 0683 
0779 0779 0779 0779 0779 0779 0779 0779 0779 0264 0265 0779 0779 0779 0779 0779 0779 0779 0779 0779 0779 0779 0779 0408 0409 0410 0779 0779 0779 0779 0779 0779 0779 0779 0779 0779 0779 0779 0264 0265 0779 0779 0779 0779 0779 0779 0779 0779 0779 0779 
0779 0779 0779 0779 0779 0779 0779 0779 0779 0296 0297 0779 0779 0779 0779 0779 0779 0779 0779 0779 0779 0779 0779 0440 0441 0442 0779 0779 0779 0779 0779 0779 0779 0779 0779 0779 0779 0779 0296 0297 0779 0779 0779 0779 0779 0779 0779 0779 0779 0779 
