000 000 000 000 000 000 000 000 000 000 000 000 000 000 000 000 000 000 000 000 000 000 000 000 000 000 000 000 000 000 000 000 000 000 000 000 000 000 000 000 000 000 000 000 000 000 000 000 000 000 
000 000 000 000 000 000 000 000 000 000 000 000 000 000 000 000 000 000 000 000 000 000 000 000 000 000 000 000 000 000 000 000 000 000 000 000 000 000 000 000 000 000 000 000 000 000 000 000 000 000 
000 000 000 000 000 000 000 000 000 000 000 000 000 000 248 000 000 000 000 000 000 000 000 000 000 000 000 000 000 000 000 000 000 000 000 000 000 000 000 000 000 000 000 000 000 000 000 000 000 000 
000 000 000 000 000 000 000 000 000 000 000 000 000 000 249 000 000 000 000 000 000 000 000 000 000 000 000 000 000 000 000 000 000 000 000 000 000 000 000 000 000 000 000 000 000 000 000 000 000 000 
000 000 000 000 000 000 000 000 000 000 000 000 000 000 248 000 000 000 000 000 000 000 000 249 000 000 000 000 000 000 000 000 000 000 000 000 000 000 000 000 000 000 000 000 000 054 000 000 000 000 
000 000 000 000 000 000 000 000 000 000 000 000 000 000 249 000 000 000 000 000 000 000 000 248 000 000 000 000 000 000 000 000 000 000 000 000 000 000 000 000 000 000 000 000 000 000 000 000 000 000 
000 000 000 000 000 000 000 000 000 000 000 000 000 000 248 000 000 000 000 000 000 000 000 249 000 000 000 000 000 000 000 000 000 000 000 000 000 000 000 000 000 000 000 000 000 000 000 000 000 000 
000 000 000 000 000 000 000 000 000 000 000 000 000 000 249 000 000 000 000 000 000 000 000 248 000 000 000 000 000 000 000 000 000 000 000 000 000 000 000 000 000 000 000 000 000 000 000 000 000 000 
000 000 000 000 000 000 000 000 000 000 000 000 000 000 248 000 000 000 000 000 000 000 000 249 000 000 000 000 000 000 000 000 000 000 000 000 000 000 000 000 000 000 000 000 000 000 000 000 000 000 
000 000 000 000 000 000 000 000 000 000 000 000 000 000 249 000 000 000 000 000 000 000 000 248 000 000 000 000 000 000 000 068 068 068 033 033 033 033 033 033 033 033 033 033 033 033 033 033 033 033 
000 000 000 000 000 000 000 000 000 000 000 000 248 249 248 249 248 000 000 000 000 000 000 249 000 000 000 000 000 000 000 076 076 076 000 000 000 000 000 000 000 000 000 000 000 000 000 000 000 000 
000 000 000 000 000 000 000 000 000 000 000 000 249 000 000 000 249 000 000 000 000 000 000 248 000 000 000 000 000 000 000 076 076 076 000 000 000 000 000 000 000 000 000 000 000 000 000 000 000 000 
000 000 000 000 000 000 000 000 000 000 000 000 248 000 000 000 248 000 000 000 000 000 000 249 000 000 000 000 000 000 000 000 000 000 000 000 000 000 000 000 000 000 000 000 000 000 000 000 000 000 
248 249 248 249 248 249 248 249 249 248 249 248 249 000 000 000 249 248 249 248 249 248 249 248 249 248 000 000 000 000 000 000 000 000 000 000 000 000 000 000 000 000 000 000 000 000 000 000 000 000  
000 000 000 000 000 000 000 000 248 000 000 000 248 000 000 000 248 000 000 000 000 000 000 249 000 000 000 000 000 000 000 000 000 000 000 000 000 000 000 000 000 000 000 000 000 000 000 000 000 000 
000 000 000 000 000 000 000 000 249 000 000 000 249 000 000 000 249 000 000 000 000 000 000 248 000 000 000 000 000 000 000 000 000 000 000 000 000 000 000 000 000 000 000 000 000 000 000 000 000 000 
000 000 000 000 000 000 000 000 248 000 000 000 248 249 248 249 248 000 000 000 000 000 000 249 000 000 000 000 000 000 000 000 000 000 000 000 000 000 000 000 000 000 000 000 000 000 000 000 000 000 
000 000 000 000 000 000 000 000 249 000 000 000 000 000 248 000 000 000 000 000 000 000 000 248 000 000 000 033 033 033 033 033 033 033 033 033 033 033 033 033 033 033 033 033 033 068 068 068 033 033 
000 000 000 000 000 000 000 000 248 000 000 000 000 000 249 000 000 000 000 000 000 000 000 249 000 000 000 000 000 000 000 000 000 000 000 000 000 000 000 000 000 000 000 000 000 076 076 076 000 000 
000 000 000 000 000 000 000 000 249 000 000 000 000 000 248 000 000 000 000 000 000 000 000 248 000 000 000 000 000 000 000 000 000 000 000 000 000 000 000 000 000 000 000 000 000 076 076 076 000 000 
248 249 248 249 248 249 248 249 248 000 000 000 000 000 249 000 000 000 000 000 000 000 000 249 000 000 000 000 000 000 000 000 000 000 000 000 000 000 000 000 000 000 000 000 000 000 000 000 000 000 
000 000 000 000 000 000 000 000 000 000 000 000 000 000 248 000 000 000 000 000 000 000 000 248 000 000 000 000 000 000 000 000 000 000 000 000 000 000 000 000 000 000 000 000 000 000 000 000 000 000 
000 000 000 000 000 000 000 000 000 000 000 000 000 000 249 000 000 000 000 000 000 000 000 249 000 000 000 000 000 000 000 000 000 000 000 000 000 000 000 000 000 000 000 000 000 000 000 000 000 000 
000 000 000 000 000 000 000 000 000 000 000 000 000 000 248 000 000 000 000 000 000 000 000 248 000 000 000 000 000 000 000 000 000 000 000 000 000 000 000 000 000 000 000 000 000 000 000 000 000 000 
000 000 000 000 000 000 000 000 000 000 000 000 000 000 249 000 000 000 000 000 000 000 000 000 000 000 000 000 000 000 000 000 000 000 000 000 000 000 000 000 000 000 000 000 000 000 000 000 000 000 
000 000 000 000 000 000 000 000 000 000 000 000 000 000 000 000 000 000 000 000 000 000 000 000 000 000 000 000 000 000 000 000 000 000 000 000 000 000 000 000 000 000 000 000 000 000 000 000 000 000 
000 000 000 000 000 000 000 000 000 000 000 000 000 000 000 000 000 000 000 000 000 000 000 000 000 000 000 000 000 000 000 000 000 000 000 000 000 000 000 000 000 000 000 000 000 000 000 000 000 000 
000 000 000 000 000 000 000 000 000 000 000 000 000 000 000 000 000 000 000 000 000 000 000 000 000 000 000 000 000 000 000 000 000 000 000 000 000 000 000 000 000 000 000 000 000 000 000 000 000 000 