000 000 000 000 000 128 129 130 131 132 000 000 000 000 000 000 000 000 000 000 000 000 000 000 000 000 000 128 129 130 131 132 128 129 130 131 132 000 000 000 000 000 128 129 130 131 132 000 000 000 
001 002 002 002 002 136 137 138 139 140 002 002 002 002 002 002 002 002 002 002 002 002 002 002 002 002 002 136 137 138 139 140 136 137 138 139 140 002 002 002 002 002 136 137 138 139 140 002 002 003 
009 010 010 010 010 144 145 146 147 148 010 010 010 010 010 010 010 010 010 010 010 010 010 010 010 010 010 144 145 146 147 148 144 145 146 147 148 010 010 010 010 010 144 145 146 147 148 010 010 011 
017 000 000 000 000 152 153 154 155 156 000 000 000 000 017 018 018 018 018 018 019 000 000 000 000 000 000 152 153 154 155 156 152 153 154 155 156 000 000 000 000 000 152 153 154 155 156 000 000 019 
017 000 000 000 000 160 161 162 163 164 000 000 000 000 017 018 018 018 018 018 019 000 000 000 000 000 000 160 161 162 163 164 160 161 162 163 164 000 000 000 000 000 160 161 162 163 164 000 000 019 
017 000 000 000 000 168 169 170 171 172 000 000 000 000 017 018 018 018 018 018 019 000 000 000 000 000 000 168 169 170 171 172 168 169 170 171 172 000 000 000 000 000 168 169 170 171 172 000 000 019 
017 000 000 000 000 176 177 178 179 180 000 000 000 000 025 026 026 026 026 026 027 000 000 000 000 000 000 176 177 178 179 180 176 177 178 179 180 000 000 000 000 000 176 177 178 179 180 000 000 019 
017 000 000 000 000 184 185 186 187 188 000 000 000 000 000 000 000 000 000 000 000 000 000 000 000 000 000 184 185 186 187 188 184 185 186 187 188 000 000 000 000 000 184 185 186 187 188 000 000 019 
017 000 000 000 000 192 193 194 195 196 000 000 000 000 000 000 000 000 000 000 000 000 000 000 000 000 000 192 193 194 195 196 192 193 194 195 196 000 000 000 000 000 192 193 194 195 196 000 000 019 
017 000 000 000 000 200 201 202 203 204 000 000 000 000 000 000 000 000 000 000 000 000 000 000 000 000 000 200 201 202 203 204 200 201 202 203 204 000 000 000 000 000 200 201 202 203 204 000 000 019 
000 000 000 000 000 000 000 000 000 000 000 000 000 000 000 000 000 000 000 000 000 000 000 000 000 000 000 000 000 000 000 000 000 000 000 000 000 000 000 000 000 000 000 000 000 000 000 000 000 000 
000 000 000 000 000 000 000 000 000 000 000 000 000 000 000 000 000 000 000 000 000 000 000 000 000 000 000 000 000 000 000 000 000 000 000 000 000 000 000 000 000 000 000 000 000 000 000 000 000 000 
000 000 000 000 000 000 000 000 000 000 000 000 000 000 000 000 000 000 000 000 000 000 000 000 000 000 000 000 000 000 000 000 000 000 000 000 000 000 000 000 000 000 000 000 000 000 000 000 000 000 
000 000 000 000 000 000 000 000 000 000 000 000 000 000 000 000 000 000 000 000 000 000 000 000 000 000 000 000 000 000 000 000 000 000 000 000 000 000 000 000 000 000 000 000 000 000 000 000 000 000 
000 000 000 000 000 000 000 000 000 000 000 000 000 000 000 000 000 000 000 000 000 000 000 000 000 000 000 000 000 000 000 000 000 000 000 000 000 000 000 000 000 000 000 000 000 000 000 000 000 000 
000 000 000 000 000 000 000 000 000 000 000 000 000 000 000 000 000 000 000 000 000 000 000 000 000 000 000 000 000 000 000 000 000 000 000 000 000 000 000 000 000 000 000 000 000 000 000 000 000 000 
000 000 000 000 000 000 000 000 000 000 000 000 000 000 128 129 130 131 132 000 000 000 000 000 128 129 130 131 132 128 129 130 131 132 000 000 000 000 000 000 000 000 000 000 000 000 000 000 000 000 
000 000 000 000 000 000 000 000 000 000 000 000 000 000 136 137 138 139 140 000 000 000 000 000 136 137 138 139 140 136 137 138 139 140 000 000 057 000 000 000 000 000 000 000 000 000 000 000 000 000 
000 000 000 000 000 000 000 000 000 000 000 000 000 000 144 145 146 147 148 000 000 000 000 000 144 145 146 147 148 144 145 146 147 148 000 000 000 000 000 000 073 074 075 073 074 075 000 000 000 000 
017 000 000 060 061 000 000 000 000 000 000 000 000 000 152 153 154 155 156 000 000 000 000 000 152 153 154 155 156 152 153 154 155 156 000 000 000 000 000 072 073 074 075 073 074 075 000 000 000 019 
017 000 000 068 070 000 000 000 000 000 000 000 000 000 160 161 162 163 164 000 000 000 000 000 160 161 162 163 164 160 161 162 163 164 000 000 000 000 000 080 073 074 075 073 074 075 000 000 000 019 
017 000 000 000 000 051 000 000 000 000 000 000 000 000 168 169 170 171 172 000 000 000 000 000 168 169 170 171 172 168 169 170 171 172 000 000 000 000 000 000 073 074 075 073 074 075 000 000 000 019 
017 000 000 000 000 000 000 000 000 000 000 000 000 000 176 177 178 179 180 000 000 000 000 000 176 177 178 179 180 176 177 178 179 180 000 000 000 000 000 000 073 074 075 073 074 075 000 000 000 019 
017 000 000 000 000 000 000 000 000 000 000 000 000 000 184 185 186 187 188 000 000 000 000 000 184 185 186 187 188 184 185 186 187 188 000 000 000 000 000 000 073 074 075 073 074 075 000 000 000 019 
017 000 000 000 000 000 000 000 000 000 000 000 000 000 192 193 194 195 196 000 000 000 000 000 192 193 194 195 196 192 193 194 195 196 000 000 000 000 000 000 073 074 075 073 074 075 000 000 000 019 
017 000 000 000 000 000 000 000 000 000 000 000 000 000 200 201 202 203 204 000 000 000 000 000 200 201 202 203 204 200 201 202 203 204 000 000 000 000 000 000 000 000 000 000 000 000 000 000 000 019 
025 026 026 026 026 026 026 026 026 026 026 026 026 026 026 026 026 026 026 026 026 026 026 026 026 026 026 026 026 026 026 026 026 026 026 026 026 026 026 026 026 026 026 026 026 026 026 026 026 027 
000 000 000 000 000 000 000 000 000 000 000 000 000 000 000 000 000 000 000 000 000 000 000 000 000 000 000 000 000 000 000 000 000 000 000 000 000 000 000 000 000 000 000 000 000 000 000 000 000 000 