041 041 041 041 041 041 041 041 041 041 041 041 041 041 041 041 041 041 041 041 041 041 041 041 045 000 047 041 041 041 041 041 041 041 041 041 041 041 041 041 041 041 041 041 041 041 041 041 041 041 
041 041 041 041 041 041 041 041 041 041 041 041 041 041 041 041 041 041 041 041 041 041 041 041 045 000 047 041 041 041 041 041 041 041 041 041 041 041 041 041 041 041 041 041 041 041 041 041 041 041 
041 041 041 041 041 041 041 041 041 041 041 041 041 041 041 041 041 041 041 041 041 041 041 041 045 000 047 041 041 041 041 041 041 041 041 041 041 041 041 041 041 041 041 041 041 041 041 041 041 041 
041 041 041 041 041 041 041 041 041 041 041 041 041 041 041 041 041 041 041 041 041 041 041 041 000 000 000 041 041 041 041 041 041 041 041 041 041 041 041 041 041 041 041 041 041 041 041 041 041 041 
041 041 041 041 041 041 041 041 041 041 041 041 041 041 041 041 041 041 041 041 041 041 041 000 000 000 000 000 041 041 041 041 041 041 041 041 041 041 041 041 041 041 041 041 041 041 041 041 041 041 
041 041 041 041 041 041 041 041 041 041 041 041 041 041 041 041 041 041 041 041 041 045 000 000 000 000 000 000 000 047 041 041 041 041 041 041 041 041 041 041 041 041 041 041 041 041 041 041 041 041 
041 041 041 041 041 041 041 041 041 041 041 041 041 041 041 041 041 041 041 041 041 045 000 000 000 000 000 000 000 047 041 041 041 041 041 041 041 041 041 041 041 041 041 041 041 041 041 041 041 041 
041 041 041 041 041 041 041 041 041 041 041 041 041 041 041 041 041 041 041 041 041 045 000 000 000 000 000 000 000 047 041 041 041 041 041 041 041 041 041 041 041 041 041 041 041 041 041 041 041 041 
041 041 041 041 041 041 041 041 041 041 041 041 041 041 041 041 041 041 041 041 041 045 000 000 000 000 000 000 000 047 041 041 041 041 041 041 041 041 041 041 041 041 041 041 041 041 041 041 041 041 
041 041 041 041 041 041 041 041 041 041 041 041 041 041 041 041 041 041 041 041 041 045 000 000 000 000 000 000 000 047 041 041 041 041 041 041 041 041 041 041 041 041 041 041 041 041 041 041 041 041 
041 041 041 041 041 041 041 041 041 041 041 041 041 041 041 041 041 041 041 041 041 045 000 000 000 000 000 000 000 047 041 041 041 041 041 041 041 041 041 041 041 041 041 041 041 041 041 041 041 041 
041 041 041 041 041 041 041 041 041 041 041 041 041 041 041 041 041 041 041 041 041 000 000 000 000 000 000 000 000 000 041 041 041 041 041 041 041 041 041 041 041 041 041 041 041 041 041 041 041 041 
041 041 041 041 041 041 041 041 041 041 041 041 041 041 041 041 041 041 041 041 045 000 000 000 000 000 000 000 000 000 047 041 041 041 041 041 041 041 041 041 041 041 041 041 041 041 041 041 041 041 
041 041 041 041 041 041 041 041 041 041 041 041 041 041 041 041 041 041 041 041 045 000 000 000 000 000 000 000 000 000 047 041 041 041 041 041 041 041 041 041 041 041 041 041 041 041 041 041 041 041 
041 041 041 041 041 041 041 041 041 041 041 041 041 041 041 041 041 041 041 041 045 000 000 000 000 000 000 000 000 000 047 041 041 041 041 041 041 041 041 041 041 041 041 041 041 041 041 041 041 041 
041 041 041 041 041 041 041 041 041 041 041 041 041 041 041 041 041 041 041 041 045 000 000 000 000 000 000 000 000 000 047 041 041 041 041 041 041 041 041 041 041 041 041 041 041 041 041 041 041 041 
041 041 041 041 041 041 041 041 041 041 041 041 041 041 041 041 041 041 041 041 000 000 000 000 000 000 000 000 000 000 000 041 041 041 041 041 041 041 041 041 041 041 041 041 041 041 041 041 041 041 
041 041 041 041 041 041 041 041 041 041 041 041 041 041 041 041 041 041 041 000 000 000 000 000 000 000 000 000 000 000 000 000 041 041 041 041 041 041 041 041 041 041 041 041 041 041 041 041 041 041 
041 041 041 041 041 041 041 041 041 041 041 041 041 041 041 041 045 000 000 000 000 000 000 000 000 000 000 000 000 000 000 000 000 000 047 041 041 041 041 041 041 041 041 041 041 041 041 041 041 041 
041 041 041 041 041 041 041 041 041 041 041 041 041 041 041 041 045 000 000 000 000 000 000 000 000 000 000 000 000 000 000 000 000 000 047 041 041 041 041 041 041 041 041 041 041 041 041 041 041 041 
041 041 041 041 041 041 041 041 041 041 041 041 041 041 041 041 053 054 054 054 054 054 054 054 054 054 054 054 054 054 054 054 054 054 055 041 041 041 041 041 041 041 041 041 041 041 041 041 041 041 
041 041 041 041 041 041 041 041 041 041 041 041 041 041 041 041 104 105 105 105 105 105 105 105 105 105 105 105 105 105 105 105 105 105 106 041 041 041 041 041 041 041 041 041 041 041 041 041 041 041 
041 041 041 041 041 041 041 041 041 041 041 041 041 041 041 041 112 113 113 113 113 113 113 113 113 113 113 113 113 113 113 113 113 113 114 041 041 041 041 041 041 041 041 041 041 041 041 041 041 041 
041 041 041 041 041 041 041 041 041 041 041 041 041 041 041 041 120 121 121 121 121 121 121 121 121 121 121 121 121 121 121 121 121 121 122 041 041 041 041 041 041 041 041 041 041 041 041 041 041 041 
041 041 041 041 041 041 041 041 041 041 041 041 041 041 041 041 128 129 129 129 129 129 129 129 129 129 129 129 129 129 129 129 129 129 130 041 041 041 041 041 041 041 041 041 041 041 041 041 041 041 
041 041 041 041 041 041 041 041 041 041 041 041 041 041 041 041 136 137 137 137 137 137 137 137 137 137 137 137 137 137 137 137 137 137 138 041 041 041 041 041 041 041 041 041 041 041 041 041 041 041 
041 041 041 041 041 041 041 041 041 041 041 041 041 041 041 041 136 137 137 137 137 137 137 137 137 137 137 137 137 137 137 137 137 137 138 041 041 041 041 041 041 041 041 041 041 041 041 041 041 041 
041 041 041 041 041 041 041 041 041 041 041 041 041 041 041 041 144 145 145 145 145 145 145 145 145 145 145 145 145 145 145 145 145 145 146 041 041 041 041 041 041 041 041 041 041 041 041 041 041 041 